species	family
Abrodictyum_asae_grayi	Hymenophyllaceae
Abrodictyum_strictum	Hymenophyllaceae
Abrodictyum_caudatum	Hymenophyllaceae
Trichomanes_flavofuscum	Hymenophyllaceae
Trichomanes_milnei	Hymenophyllaceae
Abrodictyum_boninense	Hymenophyllaceae
Abrodictyum_meifolium	Hymenophyllaceae
Abrodictyum_schlechteri	Hymenophyllaceae
Abrodictyum_brassii	Hymenophyllaceae
Abrodictyum_pachyphlebium	Hymenophyllaceae
Abrodictyum_rigidum	Hymenophyllaceae
Abrodictyum_tamarisciforme	Hymenophyllaceae
Abrodictyum_dentatum	Hymenophyllaceae
Abrodictyum_laetum	Hymenophyllaceae
Abrodictyum_obscurum	Hymenophyllaceae
Abrodictyum_elongatum	Hymenophyllaceae
Cephalomanes_javanicum	Hymenophyllaceae
Trichomanes_atrovirens	Hymenophyllaceae
Cephalomanes_boryanum	Hymenophyllaceae
Trichomanes_hostmannianum	Hymenophyllaceae
Trichomanes_pinnatum	Hymenophyllaceae
Trichomanes_polypodioides	Hymenophyllaceae
Trichomanes_scandens	Hymenophyllaceae
Trichomanes_alatum	Hymenophyllaceae
Trichomanes_trigonum	Hymenophyllaceae
Trichomanes_arbuscula	Hymenophyllaceae
Trichomanes_holopterum	Hymenophyllaceae
Trichomanes_roraimense	Hymenophyllaceae
Trichomanes_lucens	Hymenophyllaceae
Trichomanes_crispum	Hymenophyllaceae
Trichomanes_egleri	Hymenophyllaceae
Trichomanes_robustum	Hymenophyllaceae
Trichomanes_pilosum	Hymenophyllaceae
Trichomanes_galeottii	Hymenophyllaceae
Trichomanes_crinitum	Hymenophyllaceae
Trichomanes_mougeotii	Hymenophyllaceae
Trichomanes_diversifrons	Hymenophyllaceae
Trichomanes_osmundoides	Hymenophyllaceae
Trichomanes_cupressoides	Hymenophyllaceae
Trichomanes_boivinii	Hymenophyllaceae
Trichomanes_madagascariense	Hymenophyllaceae
Trichomanes_guineense	Hymenophyllaceae
Trichomanes_ankersii	Hymenophyllaceae
Trichomanes_elegans	Hymenophyllaceae
Vandenboschia_speciosa	Hymenophyllaceae
Vandenboschia_cyrtotheca	Hymenophyllaceae
Vandenboschia_davallioides	Hymenophyllaceae
Vandenboschia_striata	Hymenophyllaceae
Vandenboschia_radicans	Hymenophyllaceae
Vandenboschia_collariata	Hymenophyllaceae
Vandenboschia_johnstonensis	Hymenophyllaceae
Vandenboschia_liukiuensis	Hymenophyllaceae
Vandenboschia_maxima	Hymenophyllaceae
Vandenboschia_gigantea	Hymenophyllaceae
Vandenboschia_rupestris	Hymenophyllaceae
Vandenboschia_auriculata	Hymenophyllaceae
Crepidomanes_aphlebioides	Hymenophyllaceae
Crepidomanes_grande	Hymenophyllaceae
Crepidomanes_intermedium	Hymenophyllaceae
Crepidomanes_thysanostomum	Hymenophyllaceae
Crepidomanes_acuto_obtusum	Hymenophyllaceae
Crepidomanes_kurzii	Hymenophyllaceae
Crepidomanes_makinoi	Hymenophyllaceae
Crepidomanes_latealatum	Hymenophyllaceae
Crepidomanes_intricatum	Hymenophyllaceae
Crepidomanes_schmidianum	Hymenophyllaceae
Crepidomanes_fallax	Hymenophyllaceae
Crepidomanes_chevalieri	Hymenophyllaceae
Crepidomanes_pyxidiferum	Hymenophyllaceae
Crepidomanes_inopinatum	Hymenophyllaceae
Crepidomanes_melanotrichum	Hymenophyllaceae
Crepidomanes_trinerve	Hymenophyllaceae
Crepidomanes_mettenii	Hymenophyllaceae
Crepidomanes_africanum	Hymenophyllaceae
Crepidomanes_clarenceanum	Hymenophyllaceae
Crepidomanes_bonapartei	Hymenophyllaceae
Crepidomanes_walleri	Hymenophyllaceae
Crepidomanes_latemarginale	Hymenophyllaceae
Crepidomanes_vitiense	Hymenophyllaceae
Crepidomanes_christii	Hymenophyllaceae
Crepidomanes_bipunctatum	Hymenophyllaceae
Crepidomanes_intramarginale	Hymenophyllaceae
Crepidomanes_humile	Hymenophyllaceae
Crepidomanes_minutum	Hymenophyllaceae
Crepidomanes_mannii	Hymenophyllaceae
Trichomanes_longilabiatum	Hymenophyllaceae
Crepidomanes_frappieri	Hymenophyllaceae
Didymoglossum_erosum	Hymenophyllaceae
Didymoglossum_ekmanii	Hymenophyllaceae
Didymoglossum_kapplerianum	Hymenophyllaceae
Didymoglossum_cuspidatum	Hymenophyllaceae
Didymoglossum_bimarginatum	Hymenophyllaceae
Didymoglossum_membranaceum	Hymenophyllaceae
Didymoglossum_hymenoides	Hymenophyllaceae
Didymoglossum_reptans	Hymenophyllaceae
Didymoglossum_krausii	Hymenophyllaceae
Didymoglossum_hildebrandtii	Hymenophyllaceae
Didymoglossum_liberiense	Hymenophyllaceae
Didymoglossum_motleyi	Hymenophyllaceae
Didymoglossum_tahitense	Hymenophyllaceae
Didymoglossum_punctatum	Hymenophyllaceae
Didymoglossum_gourlianum	Hymenophyllaceae
Hymenophyllum_exiguum	Hymenophyllaceae
Didymoglossum_lorencei	Hymenophyllaceae
Didymoglossum_pinnatinervium	Hymenophyllaceae
Trichomanes_ovale	Hymenophyllaceae
Didymoglossum_barklyanum	Hymenophyllaceae
Polyphlebium_exsectum	Hymenophyllaceae
Polyphlebium_hymenophylloides	Hymenophyllaceae
Polyphlebium_diaphanum	Hymenophyllaceae
Polyphlebium_borbonicum	Hymenophyllaceae
Polyphlebium_ingae	Hymenophyllaceae
Polyphlebium_venosum	Hymenophyllaceae
Polyphlebium_vieillardii	Hymenophyllaceae
Polyphlebium_endlicherianum	Hymenophyllaceae
Polyphlebium_colensoi	Hymenophyllaceae
Polyphlebium_angustatum	Hymenophyllaceae
Polyphlebium_capillaceum	Hymenophyllaceae
Callistopteris_apiifolia	Hymenophyllaceae
Hymenophyllum_nephrophyllum	Hymenophyllaceae
Hymenophyllum_malingii	Hymenophyllaceae
Hymenophyllum_hygrometricum	Hymenophyllaceae
Hymenophyllum_hirsutum	Hymenophyllaceae
Hymenophyllum_ferrugineum	Hymenophyllaceae
Hymenophyllum_capillare	Hymenophyllaceae
Hymenophyllum_taeniatum	Hymenophyllaceae
Hymenophyllum_digitatum	Hymenophyllaceae
Hymenophyllum_lyallii	Hymenophyllaceae
Hymenophyllum_braithwaitii	Hymenophyllaceae
Hymenophyllum_frankliniae	Hymenophyllaceae
Hymenophyllum_pilosissimum	Hymenophyllaceae
Hymenophyllum_lanceolatum	Hymenophyllaceae
Hymenophyllum_leratii	Hymenophyllaceae
Hymenophyllum_flabellatum	Hymenophyllaceae
Hymenophyllum_rufescens	Hymenophyllaceae
Hymenophyllum_pallidum	Hymenophyllaceae
Hymenophyllum_scabrum	Hymenophyllaceae
Hymenophyllum_villosum	Hymenophyllaceae
Hymenophyllum_sanguinolentum	Hymenophyllaceae
Hymenophyllum_tortuosum	Hymenophyllaceae
Hymenophyllum_plicatum	Hymenophyllaceae
Hymenophyllum_paniense	Hymenophyllaceae
Hymenophyllum_heimii	Hymenophyllaceae
Hymenophyllum_cruentum	Hymenophyllaceae
Hymenophyllum_ooides	Hymenophyllaceae
Hymenophyllum_rarum	Hymenophyllaceae
Hymenophyllum_inaequale	Hymenophyllaceae
Hymenophyllum_balfourii	Hymenophyllaceae
Hymenophyllum_cuneatum	Hymenophyllaceae
Hymenophyllum_mnioides	Hymenophyllaceae
Hymenophyllum_apiculatum	Hymenophyllaceae
Hymenophyllum_kuhnii	Hymenophyllaceae
Hymenophyllum_mikawanum	Hymenophyllaceae
Hymenophyllum_polyanthos	Hymenophyllaceae
Hymenophyllum_corrugatum	Hymenophyllaceae
Hymenophyllum_coreanum	Hymenophyllaceae
Hymenophyllum_wrightii	Hymenophyllaceae
Hymenophyllum_dicranotrichum	Hymenophyllaceae
Hymenophyllum_dentatum	Hymenophyllaceae
Hymenophyllum_pectinatum	Hymenophyllaceae
Hymenophyllum_caespitosa	Hymenophyllaceae
Hymenophyllum_fucoides	Hymenophyllaceae
Hymenophyllum_secundum	Hymenophyllaceae
Hymenophyllum_wilsonii	Hymenophyllaceae
Hymenophyllum_peltatum	Hymenophyllaceae
Hymenophyllum_rugosum	Hymenophyllaceae
Hymenophyllum_tunbrigense	Hymenophyllaceae
Hymenophyllum_howense	Hymenophyllaceae
Hymenophyllum_multifidum	Hymenophyllaceae
Hymenophyllum_minimum	Hymenophyllaceae
Hymenophyllum_armstrongii	Hymenophyllaceae
Hymenophyllum_marginatum	Hymenophyllaceae
Hymenophyllum_tenellum	Hymenophyllaceae
Hymenophyllum_sibthorpioides	Hymenophyllaceae
Hymenophyllum_perrieri	Hymenophyllaceae
Hymenophyllum_feejeense	Hymenophyllaceae
Hymenophyllum_bivalve	Hymenophyllaceae
Didymoglossum_baileyanum	Hymenophyllaceae
Hymenophyllum_revolutum	Hymenophyllaceae
Hymenophyllum_moorei	Hymenophyllaceae
Hymenophyllum_deplanchei	Hymenophyllaceae
Hymenophyllum_rolandi_principis	Hymenophyllaceae
Hymenophyllum_dimidiatum	Hymenophyllaceae
Hymenophyllum_acanthoides	Hymenophyllaceae
Hymenophyllum_denticulatum	Hymenophyllaceae
Hymenophyllum_fuscum	Hymenophyllaceae
Hymenophyllum_subdimidiatum	Hymenophyllaceae
Hymenophyllum_oligosorum	Hymenophyllaceae
Hymenophyllum_barbatum	Hymenophyllaceae
Hymenophyllum_exsertum	Hymenophyllaceae
Hymenophyllum_serrulatum	Hymenophyllaceae
Hymenophyllum_cupressiforme	Hymenophyllaceae
Hymenophyllum_pumilum	Hymenophyllaceae
Hymenophyllum_dilatatum	Hymenophyllaceae
Hymenophyllum_reniforme	Hymenophyllaceae
Hymenophyllum_fuciforme	Hymenophyllaceae
Hymenophyllum_pulcherrimum	Hymenophyllaceae
Hymenophyllum_demissum	Hymenophyllaceae
Hymenophyllum_flexile	Hymenophyllaceae
Trichomanes_badium	Hymenophyllaceae
Hymenophyllum_javanicum	Hymenophyllaceae
Hymenophyllum_riukiuense	Hymenophyllaceae
Hymenophyllum_gracilescens	Hymenophyllaceae
Hymenophyllum_flexuosum	Hymenophyllaceae
Hymenophyllum_australe	Hymenophyllaceae
Hymenophyllum_atrovirens	Hymenophyllaceae
Hymenophyllum_imbricatum	Hymenophyllaceae
Hymenophyllum_caudiculatum	Hymenophyllaceae
Lygodium_palmatum	Lygodiaceae
Lygodium_articulatum	Lygodiaceae
Lygodium_reticulatum	Lygodiaceae
Lygodium_microphyllum	Lygodiaceae
Lygodium_kerstenii	Lygodiaceae
Lygodium_lanceolatum	Lygodiaceae
Lygodium_micans	Lygodiaceae
Lygodium_volubile	Lygodiaceae
Lygodium_cubense	Lygodiaceae
Lygodium_oligostachyum	Lygodiaceae
Lygodium_smithianum	Lygodiaceae
Lygodium_polystachyum	Lygodiaceae
Lygodium_venustum	Lygodiaceae
Lygodium_japonicum	Lygodiaceae
Lygodium_circinatum	Lygodiaceae
Lygodium_radiatum	Lygodiaceae
Lygodium_salicifolium	Lygodiaceae
Lygodium_flexuosum	Lygodiaceae
Lygodium_heterodoxum	Lygodiaceae
Schizaea_pusilla	Schizaeaceae
Schizaea_pectinata	Schizaeaceae
Schizaea_poeppigiana	Schizaeaceae
Schizaea_stricta	Schizaeaceae
Schizaea_dichotoma	Schizaeaceae
Actinostachys_pennula	Schizaeaceae
Schizaea_subtrijuga	Schizaeaceae
Schizaea_laevigata	Schizaeaceae
Schizaea_confusa	Schizaeaceae
Schizaea_digitata	Schizaeaceae
Anemia_hirta	Anemiaceae
Anemia_dregeana	Anemiaceae
Anemia_radicans	Anemiaceae
Anemia_oblongifolia	Anemiaceae
Anemia_tenella	Anemiaceae
Anemia_hirsuta	Anemiaceae
Anemia_semihirsuta	Anemiaceae
Anemia_jaliscana	Anemiaceae
Anemia_muenchii	Anemiaceae
Anemia_phyllitidis	Anemiaceae
Anemia_underwoodiana	Anemiaceae
Anemia_pastinacaria	Anemiaceae
Anemia_rotundifolia	Anemiaceae
Anemia_tomentosa	Anemiaceae
Anemia_villosa	Anemiaceae
Anemia_angolensis	Anemiaceae
Anemia_myriophylla	Anemiaceae
Anemia_caffrorum	Anemiaceae
Anemia_marginalis	Anemiaceae
Anemia_adiantifolia	Anemiaceae
Anemia_wrightii	Anemiaceae
Anemia_cicutaria	Anemiaceae
Anemia_mexicana	Anemiaceae
Marsilea_botryocarpa	Marsileaceae
Marsilea_macrocarpa	Marsileaceae
Marsilea_aegyptiaca	Marsileaceae
Marsilea_ephippiocarpa	Marsileaceae
Marsilea_farinosa	Marsileaceae
Marsilea_schelpeana	Marsileaceae
Marsilea_vera	Marsileaceae
Marsilea_villifolia	Marsileaceae
Marsilea_ancylopoda	Marsileaceae
Marsilea_mucronata	Marsileaceae
Marsilea_villosa	Marsileaceae
Marsilea_fournieri	Marsileaceae
Marsilea_tenuifolia	Marsileaceae
Marsilea_vestita	Marsileaceae
Marsilea_oligospora	Marsileaceae
Marsilea_macropoda	Marsileaceae
Marsilea_uncinata	Marsileaceae
Marsilea_nashii	Marsileaceae
Marsilea_mollis	Marsileaceae
Marsilea_minuta	Marsileaceae
Marsilea_fadeniana	Marsileaceae
Marsilea_crenata	Marsileaceae
Marsilea_exarata	Marsileaceae
Marsilea_costulifera	Marsileaceae
Marsilea_hirsuta	Marsileaceae
Marsilea_azorica	Marsileaceae
Marsilea_angustifolia	Marsileaceae
Marsilea_drummondii	Marsileaceae
Marsilea_strigosa	Marsileaceae
Marsilea_quadrifolia	Marsileaceae
Marsilea_crenulata	Marsileaceae
Marsilea_gibba	Marsileaceae
Marsilea_capensis	Marsileaceae
Marsilea_distorta	Marsileaceae
Marsilea_coromandelina	Marsileaceae
Marsilea_mutica	Marsileaceae
Marsilea_deflexa	Marsileaceae
Marsilea_crotophora	Marsileaceae
Marsilea_polycarpa	Marsileaceae
Marsilea_scalaripes	Marsileaceae
Regnellidium_diphyllum	Marsileaceae
Pilularia_americana	Marsileaceae
Pilularia_novae_zelandiae	Marsileaceae
Pilularia_novae_hollandiae	Marsileaceae
Pilularia_minuta	Marsileaceae
Pilularia_globulifera	Marsileaceae
Salvinia_minima	Salviniaceae
Salvinia_oblongifolia	Salviniaceae
Salvinia_molesta	Salviniaceae
Salvinia_cucullata	Salviniaceae
Salvinia_natans	Salviniaceae
Azolla_nilotica	Salviniaceae
Azolla_pinnata	Salviniaceae
Azolla_imbricata	Salviniaceae
Azolla_rubra	Salviniaceae
Azolla_japonica	Salviniaceae
Azolla_filiculoides	Salviniaceae
Azolla_microphylla	Salviniaceae
Azolla_cristata	Salviniaceae
Azolla_mexicana	Salviniaceae
Azolla_caroliniana	Salviniaceae
Adiantum_subcordatum	Pteridaceae
Adiantum_flabellulatum	Pteridaceae
Adiantum_induratum	Pteridaceae
Adiantum_jordanii	Pteridaceae
Adiantum_capillus_veneris	Pteridaceae
Adiantum_ogasawarense	Pteridaceae
Adiantum_philippense	Pteridaceae
Adiantum_menglianense	Pteridaceae
Adiantum_hirsutum	Pteridaceae
Adiantum_sinicum	Pteridaceae
Adiantum_meishanianum	Pteridaceae
Adiantum_malesianum	Pteridaceae
Adiantum_mariesii	Pteridaceae
Adiantum_leveillei	Pteridaceae
Adiantum_lianxianense	Pteridaceae
Adiantum_gravesii	Pteridaceae
Adiantum_chienii	Pteridaceae
Adiantum_juxtapositum	Pteridaceae
Adiantum_edgeworthii	Pteridaceae
Adiantum_caudatum	Pteridaceae
Adiantum_capillus_junonis	Pteridaceae
Adiantum_rhizophorum	Pteridaceae
Adiantum_fimbriatum	Pteridaceae
Adiantum_fengianum	Pteridaceae
Adiantum_davidii	Pteridaceae
Adiantum_venustum	Pteridaceae
Adiantum_bonatianum	Pteridaceae
Adiantum_roborowskii	Pteridaceae
Adiantum_monochlamys	Pteridaceae
Adiantum_reniforme	Pteridaceae
Adiantum_myriosorum	Pteridaceae
Adiantum_viridimontanum	Pteridaceae
Adiantum_aleuticum	Pteridaceae
Adiantum_pedatum	Pteridaceae
Adiantum_edentulum	Pteridaceae
Adiantum_formosanum	Pteridaceae
Adiantum_princeps	Pteridaceae
Adiantum_tenerum	Pteridaceae
Adiantum_pentadactylon	Pteridaceae
Adiantum_terminatum	Pteridaceae
Adiantum_obliquum	Pteridaceae
Adiantum_latifolium	Pteridaceae
Adiantum_serratodentatum	Pteridaceae
Adiantum_cajennense	Pteridaceae
Adiantum_tetraphyllum	Pteridaceae
Adiantum_argutum	Pteridaceae
Adiantum_adiantoides	Pteridaceae
Adiantum_peruvianum	Pteridaceae
Adiantum_trapeziforme	Pteridaceae
Adiantum_polyphyllum	Pteridaceae
Adiantum_formosum	Pteridaceae
Adiantum_aethiopicum	Pteridaceae
Adiantum_silvaticum	Pteridaceae
Adiantum_cunninghamii	Pteridaceae
Adiantum_fulvum	Pteridaceae
Adiantum_viridescens	Pteridaceae
Adiantum_diaphanum	Pteridaceae
Adiantum_hispidulum	Pteridaceae
Adiantum_pubescens	Pteridaceae
Adiantum_poiretii	Pteridaceae
Adiantum_chilense	Pteridaceae
Adiantum_excisum	Pteridaceae
Adiantum_raddianum	Pteridaceae
Adiantum_concinnum	Pteridaceae
Antrophyum_smithii	Pteridaceae
Antrophyum_subfalcatum	Pteridaceae
Antrophyum_ledermannii	Pteridaceae
Antrophyum_megistophyllum	Pteridaceae
Antrophyum_plantagineum	Pteridaceae
Antrophyum_parvulum	Pteridaceae
Antrophyum_immersum	Pteridaceae
Antrophyum_latifolium	Pteridaceae
Antrophyum_semicostatum	Pteridaceae
Antrophyum_sessilifolium	Pteridaceae
Antrophyum_callifolium	Pteridaceae
Antrophyum_reticulatum	Pteridaceae
Antrophyum_formosanum	Pteridaceae
Antrophyum_henryi	Pteridaceae
Antrophyum_castaneum	Pteridaceae
Antrophyum_obovatum	Pteridaceae
Antrophyum_giganteum	Pteridaceae
Scoliosorus_boryanus	Pteridaceae
Vittaria_isoetifolia	Pteridaceae
Vittaria_lineata	Pteridaceae
Vittaria_dimorpha	Pteridaceae
Vittaria_graminifolia	Pteridaceae
Vittaria_appalachiana	Pteridaceae
Ananthacorus_angustifolius	Pteridaceae
Scoliosorus_ensiforme	Pteridaceae
Polytaenium_lanceolatum	Pteridaceae
Polytaenium_cajenense	Pteridaceae
Polytaenium_lineatum	Pteridaceae
Anetium_citrifolium	Pteridaceae
Hecistopteris_pumila	Pteridaceae
Radiovittaria_stipitata	Pteridaceae
Radiovittaria_gardneriana	Pteridaceae
Radiovittaria_remota	Pteridaceae
Radiovittaria_minima	Pteridaceae
Haplopteris_taeniophylla	Pteridaceae
Haplopteris_linearifolia	Pteridaceae
Haplopteris_fudzinoi	Pteridaceae
Haplopteris_doniana	Pteridaceae
Haplopteris_mediosora	Pteridaceae
Monogramma_dareicarpa	Pteridaceae
Haplopteris_ensiformis	Pteridaceae
Haplopteris_hainanensis	Pteridaceae
Haplopteris_sikkimensis	Pteridaceae
Haplopteris_angustifolia	Pteridaceae
Haplopteris_elongata	Pteridaceae
Haplopteris_zosterifolia	Pteridaceae
Vittaria_ogasawarensis	Pteridaceae
Haplopteris_anguste_elongata	Pteridaceae
Haplopteris_forrestiana	Pteridaceae
Haplopteris_flexuosa	Pteridaceae
Haplopteris_amboinensis	Pteridaceae
Haplopteris_heterophylla	Pteridaceae
Haplopteris_scolopendrina	Pteridaceae
Monogramma_graminea	Pteridaceae
Haplopteris_volkensii	Pteridaceae
Monogramma_trichoidea	Pteridaceae
Monogramma_acrocarpa	Pteridaceae
Vaginularia_angustissima	Pteridaceae
Rheopteris_cheesmaniae	Pteridaceae
Vaginularia_paradoxa	Pteridaceae
Vaginularia_trichoidea	Pteridaceae
Bommeria_hispida	Pteridaceae
Bommeria_ehrenbergiana	Pteridaceae
Hemionitis_elegans	Pteridaceae
Notholaena_standleyi	Pteridaceae
Cheilanthes_brachypus	Pteridaceae
Cheilanthes_aurantiaca	Pteridaceae
Cheilanthes_aurea	Pteridaceae
Notholaena_meridionalis	Pteridaceae
Notholaena_greggii	Pteridaceae
Notholaena_sulphurea	Pteridaceae
Notholaena_bryopoda	Pteridaceae
Notholaena_neglecta	Pteridaceae
Notholaena_candida	Pteridaceae
Notholaena_copelandii	Pteridaceae
Notholaena_californica	Pteridaceae
Notholaena_affinis	Pteridaceae
Notholaena_trichomanoides	Pteridaceae
Notholaena_montieliae	Pteridaceae
Notholaena_rosei	Pteridaceae
Notholaena_aliena	Pteridaceae
Notholaena_grayi	Pteridaceae
Notholaena_schaffneri	Pteridaceae
Notholaena_aschenborniana	Pteridaceae
Notholaena_nealleyi	Pteridaceae
Notholaena_rigida	Pteridaceae
Cheilanthes_leucopoda	Pteridaceae
Aleuritopteris_leptolepis	Pteridaceae
Cheilanthes_farinosa	Pteridaceae
Aleuritopteris_formosana	Pteridaceae
Aleuritopteris_pseudofarinosa	Pteridaceae
Aleuritopteris_rufa	Pteridaceae
Cheilanthes_albomarginata	Pteridaceae
Aleuritopteris_farinosa	Pteridaceae
Cheilanthes_krameri	Pteridaceae
Cheilanthes_grisea	Pteridaceae
Aleuritopteris_kuhnii	Pteridaceae
Cheilanthes_brandtii	Pteridaceae
Aleuritopteris_subvillosa	Pteridaceae
Aleuritopteris_rosulata	Pteridaceae
Aleuritopteris_squamosa	Pteridaceae
Aleuritopteris_duclouxii	Pteridaceae
Aleuritopteris_humatifolia	Pteridaceae
Aleuritopteris_chrysophylla	Pteridaceae
Aleuritopteris_veitchii	Pteridaceae
Aleuritopteris_likiangensis	Pteridaceae
Cheilanthes_hancockii	Pteridaceae
Pellaea_trichophylla	Pteridaceae
Cheilanthes_insignis	Pteridaceae
Cheilanthes_christii	Pteridaceae
Cheilanthes_brausei	Pteridaceae
Cheilanthes_smithii	Pteridaceae
Cheilanthes_tibetica	Pteridaceae
Cheilanthes_argentea	Pteridaceae
Aleuritopteris_shensiensis	Pteridaceae
Aleuritopteris_subargentea	Pteridaceae
Cheilanthes_duclouxii	Pteridaceae
Cheilanthes_nitidula	Pteridaceae
Pellaea_patula	Pteridaceae
Cheilanthes_chusana	Pteridaceae
Aleuritopteris_tamburii	Pteridaceae
Pellaea_pectiniformis	Pteridaceae
Cheilanthes_leachii	Pteridaceae
Pellaea_doniana	Pteridaceae
Doryopteris_pedatoides	Pteridaceae
Doryopteris_pilosa	Pteridaceae
Pellaea_dura	Pteridaceae
Pellaea_longipilosa	Pteridaceae
Pellaea_angulosa	Pteridaceae
Pellaea_boivinii	Pteridaceae
Pellaea_maxima	Pteridaceae
Hemionitis_levyi	Pteridaceae
Hemionitis_palmata	Pteridaceae
Hemionitis_tomentosa	Pteridaceae
Hemionitis_rufa	Pteridaceae
Hemionitis_arifolia	Pteridaceae
Trachypteris_pinnata	Pteridaceae
Pellaea_pteroides	Pteridaceae
Cheilanthes_multifida	Pteridaceae
Cheilanthes_induta	Pteridaceae
Cheilanthes_namaquensis	Pteridaceae
Pellaea_calomelanos	Pteridaceae
Pellaea_flavescens	Pteridaceae
Cheilanthes_viridis	Pteridaceae
Cheilanthes_involuta	Pteridaceae
Cheilanthes_pentagona	Pteridaceae
Cheilanthes_quadripinnata	Pteridaceae
Pellaea_pinnata	Pteridaceae
Doryopteris_ornithopus	Pteridaceae
Doryopteris_paradoxa	Pteridaceae
Doryopteris_lomariacea	Pteridaceae
Pellaea_cymbiformis	Pteridaceae
Pellaea_riedelii	Pteridaceae
Pellaea_crenata	Pteridaceae
Pellaea_gleichenioides	Pteridaceae
Doryopteris_triphylla	Pteridaceae
Doryopteris_concolor	Pteridaceae
Cheilanthes_decora	Pteridaceae
Doryopteris_pentagona	Pteridaceae
Doryopteris_lorentzii	Pteridaceae
Doryopteris_sagittifolia	Pteridaceae
Doryopteris_pedata	Pteridaceae
Doryopteris_nobilis	Pteridaceae
Doryopteris_rediviva	Pteridaceae
Doryopteris_collina	Pteridaceae
Cheilanthes_venusta	Pteridaceae
Cheilanthes_goyazensis	Pteridaceae
Adiantopsis_flexuosa	Pteridaceae
Adiantopsis_paupercula	Pteridaceae
Adiantopsis_timida	Pteridaceae
Adiantopsis_seemannii	Pteridaceae
Adiantopsis_monticola	Pteridaceae
Adiantopsis_reesii	Pteridaceae
Adiantopsis_pedata	Pteridaceae
Adiantopsis_pentagona	Pteridaceae
Adiantopsis_rupicola	Pteridaceae
Adiantopsis_vincentii	Pteridaceae
Adiantopsis_parvisegmenta	Pteridaceae
Adiantopsis_perfasciculata	Pteridaceae
Adiantopsis_radiata	Pteridaceae
Adiantopsis_ternata	Pteridaceae
Adiantopsis_dactylifera	Pteridaceae
Adiantopsis_trifurcata	Pteridaceae
Adiantopsis_lindigii	Pteridaceae
Adiantopsis_senae	Pteridaceae
Adiantopsis_tweediana	Pteridaceae
Adiantopsis_dichotoma	Pteridaceae
Adiantopsis_chlorophylla	Pteridaceae
Adiantopsis_regularis	Pteridaceae
Aspidotis_californica	Pteridaceae
Aspidotis_meifolia	Pteridaceae
Aspidotis_carlotta_halliae	Pteridaceae
Aspidotis_densa	Pteridaceae
Gaga_arizonica	Pteridaceae
Gaga_lerstenii	Pteridaceae
Gaga_germanotta	Pteridaceae
Gaga_monstraparva	Pteridaceae
Cheilanthes_buchtienii	Pteridaceae
Cheilanthes_sieberi	Pteridaceae
Cheilanthes_distans	Pteridaceae
Cheilanthes_lasiophylla	Pteridaceae
Cheilanthes_nudiuscula	Pteridaceae
Cheilanthes_micropteris	Pteridaceae
Cheilanthes_hastata	Pteridaceae
Cheilanthes_robusta	Pteridaceae
Cheilanthes_capensis	Pteridaceae
Cheilanthes_deltoidea	Pteridaceae
Cheilanthes_rufopunctata	Pteridaceae
Cheilanthes_marlothii	Pteridaceae
Cheilanthes_eckloniana	Pteridaceae
Cheilanthes_contracta	Pteridaceae
Cheilanthes_parviloba	Pteridaceae
Cheilanthes_depauperata	Pteridaceae
Cheilanthes_hirta	Pteridaceae
Cheilanthes_bergiana	Pteridaceae
Cheilanthes_dinteri	Pteridaceae
Cheilanthes_intramarginalis	Pteridaceae
Pentagramma_triangularis	Pteridaceae
Cheilanthes_chinensis	Pteridaceae
Cheilanthes_guanchica	Pteridaceae
Cheilanthes_maderensis	Pteridaceae
Cheilanthes_acrostica	Pteridaceae
Cheilanthes_pulchella	Pteridaceae
Aleuritopteris_albofusca	Pteridaceae
Aleuritopteris_grevilleoides	Pteridaceae
Cheilanthes_niphobola	Pteridaceae
Cheilanthes_bolborrhiza	Pteridaceae
Cheilanthes_skinneri	Pteridaceae
Myriopteris_pringlei	Pteridaceae
Myriopteris_peninsularis	Pteridaceae
Myriopteris_mickelii	Pteridaceae
Myriopteris_allosuroides	Pteridaceae
Myriopteris_aemula	Pteridaceae
Myriopteris_scabra	Pteridaceae
Myriopteris_fimbriata	Pteridaceae
Myriopteris_moritziana	Pteridaceae
Myriopteris_microphylla	Pteridaceae
Myriopteris_notholaenoides	Pteridaceae
Myriopteris_cucullans	Pteridaceae
Myriopteris_alabamensis	Pteridaceae
Myriopteris_wrightii	Pteridaceae
Myriopteris_aurea	Pteridaceae
Myriopteris_yatskievychiana	Pteridaceae
Myriopteris_newberryi	Pteridaceae
Myriopteris_tomentosa	Pteridaceae
Myriopteris_chipinquensis	Pteridaceae
Myriopteris_jamaicensis	Pteridaceae
Myriopteris_rufa	Pteridaceae
Myriopteris_windhamii	Pteridaceae
Myriopteris_myriophylla	Pteridaceae
Myriopteris_marsupianthes	Pteridaceae
Myriopteris_mexicana	Pteridaceae
Myriopteris_lendigera	Pteridaceae
Myriopteris_covillei	Pteridaceae
Myriopteris_clevelandii	Pteridaceae
Myriopteris_fendleri	Pteridaceae
Myriopteris_wootonii	Pteridaceae
Myriopteris_intertexta	Pteridaceae
Myriopteris_gracillima	Pteridaceae
Myriopteris_yavapensis	Pteridaceae
Myriopteris_lindheimeri	Pteridaceae
Myriopteris_rawsonii	Pteridaceae
Myriopteris_parryi	Pteridaceae
Myriopteris_lanosa	Pteridaceae
Myriopteris_longipila	Pteridaceae
Myriopteris_gracilis	Pteridaceae
Myriopteris_cooperae	Pteridaceae
Myriopteris_viscida	Pteridaceae
Argyrochosma_incana	Pteridaceae
Argyrochosma_pallens	Pteridaceae
Argyrochosma_palmeri	Pteridaceae
Argyrochosma_pilifera	Pteridaceae
Argyrochosma_peninsularis	Pteridaceae
Argyrochosma_delicatula	Pteridaceae
Argyrochosma_stuebeliana	Pteridaceae
Argyrochosma_nivea	Pteridaceae
Argyrochosma_dealbata	Pteridaceae
Argyrochosma_limitanea	Pteridaceae
Argyrochosma_jonesii	Pteridaceae
Argyrochosma_formosa	Pteridaceae
Argyrochosma_lumholtzii	Pteridaceae
Argyrochosma_microphylla	Pteridaceae
Argyrochosma_fendleri	Pteridaceae
Pellaea_atropurpurea	Pteridaceae
Pellaea_notabilis	Pteridaceae
Pellaea_pringlei	Pteridaceae
Pellaea_andromedifolia	Pteridaceae
Pellaea_intermedia	Pteridaceae
Pellaea_ovata	Pteridaceae
Pellaea_rufa	Pteridaceae
Pellaea_lyngholmii	Pteridaceae
Pellaea_truncata	Pteridaceae
Pellaea_mucronata	Pteridaceae
Pellaea_wrightiana	Pteridaceae
Pellaea_brachyptera	Pteridaceae
Pellaea_ternifolia	Pteridaceae
Pellaea_bridgesii	Pteridaceae
Paragymnopteris_vestita	Pteridaceae
Paragymnopteris_bipinnata	Pteridaceae
Paragymnopteris_sargentii	Pteridaceae
Pellaea_rotundifolia	Pteridaceae
Pellaea_paradoxa	Pteridaceae
Pellaea_falcata	Pteridaceae
Pellaea_calidirupium	Pteridaceae
Paraceterach_muelleri	Pteridaceae
Astrolepis_integerrima	Pteridaceae
Astrolepis_cochisensis	Pteridaceae
Astrolepis_windhamii	Pteridaceae
Astrolepis_sinuata	Pteridaceae
Pellaea_cordifolia	Pteridaceae
Pellaea_sagittata	Pteridaceae
Pellaea_breweri	Pteridaceae
Paragymnopteris_marantae	Pteridaceae
Paragymnopteris_delavayi	Pteridaceae
Calciphilopteris_ludens	Pteridaceae
Pteris_platyzomopsis	Pteridaceae
Onychium_tenuifrons	Pteridaceae
Onychium_siliculosum	Pteridaceae
Onychium_plumosum	Pteridaceae
Onychium_contiguum	Pteridaceae
Onychium_lucidum	Pteridaceae
Onychium_japonicum	Pteridaceae
Actiniopteris_semiflabellata	Pteridaceae
Actiniopteris_radiata	Pteridaceae
Actiniopteris_australis	Pteridaceae
Actiniopteris_dimorpha	Pteridaceae
Pteris_vittata	Pteridaceae
Pteris_moluccana	Pteridaceae
Pteris_papuana	Pteridaceae
Pteris_geminata	Pteridaceae
Pteris_griseoviridis	Pteridaceae
Pteris_elongatiloba	Pteridaceae
Pteris_laurea	Pteridaceae
Pteris_scabra	Pteridaceae
Pteris_tremula	Pteridaceae
Pteris_kingiana	Pteridaceae
Pteris_croesus	Pteridaceae
Pteris_leptophylla	Pteridaceae
Pteris_denticulata	Pteridaceae
Pteris_propinqua	Pteridaceae
Pteris_lechleri	Pteridaceae
Pteris_brasiliensis	Pteridaceae
Pteris_splendens	Pteridaceae
Pteris_pungens	Pteridaceae
Afropteris_barklyae	Pteridaceae
Pteris_dactylina	Pteridaceae
Pteris_guangdongensis	Pteridaceae
Pteris_cretica	Pteridaceae
Taenitis_pinnata	Pteridaceae
Pteris_ryukyuensis	Pteridaceae
Pteris_esquirolii	Pteridaceae
Pteris_nipponica	Pteridaceae
Pteris_umbrosa	Pteridaceae
Pteris_irregularis	Pteridaceae
Pteris_multifida	Pteridaceae
Pteris_yamatensis	Pteridaceae
Pteris_angustipinna	Pteridaceae
Pteris_henryi	Pteridaceae
Pteris_gallinopes	Pteridaceae
Pteris_actiniopteroides	Pteridaceae
Pteris_kidoi	Pteridaceae
Pteris_multiaurita	Pteridaceae
Pteris_deltodon	Pteridaceae
Pteris_pseudopellucida	Pteridaceae
Pteris_tibetica	Pteridaceae
Pteris_altissima	Pteridaceae
Pteris_deflexa	Pteridaceae
Pteris_muricata	Pteridaceae
Pteris_decurrens	Pteridaceae
Ochropteris_pallens	Pteridaceae
Pteris_macilenta	Pteridaceae
Pteris_saxatilis	Pteridaceae
Pteris_comans	Pteridaceae
Pteris_microptera	Pteridaceae
Pteris_litoralis	Pteridaceae
Pteris_vieillardii	Pteridaceae
Pteris_reptans	Pteridaceae
Pteris_warburgii	Pteridaceae
Pteris_pseudolonchitis	Pteridaceae
Pteris_tripartita	Pteridaceae
Pteris_wallichiana	Pteridaceae
Pteris_arborea	Pteridaceae
Pteris_mertensioides	Pteridaceae
Pteris_glaucovirens	Pteridaceae
Pteris_nevillei	Pteridaceae
Pteris_dentata	Pteridaceae
Pteris_incompleta	Pteridaceae
Pteris_woodwardioides	Pteridaceae
Pteris_formosana	Pteridaceae
Pteris_excelsa	Pteridaceae
Pteris_friesii	Pteridaceae
Pteris_ensiformis	Pteridaceae
Pteris_venusta	Pteridaceae
Pteris_vitiensis	Pteridaceae
Neurocallis_praestantissima	Pteridaceae
Pteris_insignis	Pteridaceae
Pteris_pellucida	Pteridaceae
Pteris_heteromorpha	Pteridaceae
Pteris_schlechteri	Pteridaceae
Pteris_nakasimae	Pteridaceae
Pteris_tokioi	Pteridaceae
Pteris_pteridioides	Pteridaceae
Pteris_longipes	Pteridaceae
Pteris_dataensis	Pteridaceae
Pteris_boninensis	Pteridaceae
Pteris_yakuinsularis	Pteridaceae
Pteris_oshimensis	Pteridaceae
Pteris_praetermissa	Pteridaceae
Pteris_ottaria	Pteridaceae
Pteris_pacifica	Pteridaceae
Pteris_kathmanduensis	Pteridaceae
Pteris_satsumana	Pteridaceae
Pteris_setulosocostulata	Pteridaceae
Pteris_himalayensis	Pteridaceae
Pteris_medogensis	Pteridaceae
Pteris_spinescens	Pteridaceae
Pteris_kiuschiuensis	Pteridaceae
Pteris_kawabatae	Pteridaceae
Pteris_natiensis	Pteridaceae
Pteris_laurisilvicola	Pteridaceae
Pteris_arisanensis	Pteridaceae
Pteris_wulaiensis	Pteridaceae
Pteris_porphyrophlebia	Pteridaceae
Pteris_fauriei	Pteridaceae
Pteris_linearis	Pteridaceae
Pteris_giasii	Pteridaceae
Pteris_aspericaulis	Pteridaceae
Pteris_confusa	Pteridaceae
Pteris_argyraea	Pteridaceae
Pteris_perrottetii	Pteridaceae
Pteris_flava	Pteridaceae
Pteris_khasiana	Pteridaceae
Pteris_assamica	Pteridaceae
Pteris_quadriaurita	Pteridaceae
Pteris_humbertii	Pteridaceae
Pteris_catoptera	Pteridaceae
Pteris_keysseri	Pteridaceae
Pteris_scabristipes	Pteridaceae
Pteris_scabririgens	Pteridaceae
Pteris_scabripes	Pteridaceae
Pteris_normalis	Pteridaceae
Pteris_bella	Pteridaceae
Pteris_biaurita	Pteridaceae
Pteris_mucronulata	Pteridaceae
Pteris_asperula	Pteridaceae
Pteris_roseolilacina	Pteridaceae
Pteris_amoena	Pteridaceae
Pteris_puberula	Pteridaceae
Pteris_subquinata	Pteridaceae
Pteris_decrescens	Pteridaceae
Pteris_venulosa	Pteridaceae
Pteris_cadieri	Pteridaceae
Pteris_grevilleana	Pteridaceae
Pteris_semipinnata	Pteridaceae
Pteris_dissitifolia	Pteridaceae
Pteris_dispar	Pteridaceae
Pteris_podophylla	Pteridaceae
Pteris_longifolia	Pteridaceae
Pterozonium_reniforme	Pteridaceae
Pterozonium_brevifrons	Pteridaceae
Pterozonium_cyclosorum	Pteridaceae
Tryonia_schwackeana	Pteridaceae
Tryonia_areniticola	Pteridaceae
Tryonia_myriophylla	Pteridaceae
Taenitis_interrupta	Pteridaceae
Taenitis_blechnoides	Pteridaceae
Syngramma_quinata	Pteridaceae
Austrogramme_decipiens	Pteridaceae
Austrogramme_marginata	Pteridaceae
Jamesonia_hirta	Pteridaceae
Jamesonia_cheilanthoides	Pteridaceae
Jamesonia_elongata	Pteridaceae
Jamesonia_cuatrecasasii	Pteridaceae
Jamesonia_flexuosa	Pteridaceae
Eriosorus_hispidulus	Pteridaceae
Eriosorus_hirsutulus	Pteridaceae
Eriosorus_lindigii	Pteridaceae
Jamesonia_pulchra	Pteridaceae
Jamesonia_alstonii	Pteridaceae
Jamesonia_laxa	Pteridaceae
Jamesonia_brasiliensis	Pteridaceae
Jamesonia_rotundifolia	Pteridaceae
Jamesonia_imbricata	Pteridaceae
Jamesonia_canescens	Pteridaceae
Jamesonia_bogotensis	Pteridaceae
Eriosorus_insignis	Pteridaceae
Eriosorus_novogranatensis	Pteridaceae
Jamesonia_congesta	Pteridaceae
Jamesonia_warscewiczii	Pteridaceae
Jamesonia_peruviana	Pteridaceae
Eriosorus_longipetiolatus	Pteridaceae
Eriosorus_setulosus	Pteridaceae
Eriosorus_rufescens	Pteridaceae
Jamesonia_goudotii	Pteridaceae
Jamesonia_verticalis	Pteridaceae
Jamesonia_cinnamomea	Pteridaceae
Jamesonia_blepharum	Pteridaceae
Anogramma_osteniana	Pteridaceae
Cosentinia_vellea	Pteridaceae
Anogramma_leptophylla	Pteridaceae
Anogramma_guatemalensis	Pteridaceae
Anogramma_caespitosa	Pteridaceae
Anogramma_lorentzii	Pteridaceae
Anogramma_novogaliciana	Pteridaceae
Anogramma_ascensionis	Pteridaceae
Anogramma_chaerophylla	Pteridaceae
Cerosora_microphylla	Pteridaceae
Pityrogramma_trifoliata	Pteridaceae
Pityrogramma_calomelanos	Pteridaceae
Pityrogramma_austroamericana	Pteridaceae
Pityrogramma_jamesonii	Pteridaceae
Llavea_cordifolia	Pteridaceae
Cryptogramma_acrostichoides	Pteridaceae
Cryptogramma_sitchensis	Pteridaceae
Cryptogramma_cascadensis	Pteridaceae
Cryptogramma_crispa	Pteridaceae
Cryptogramma_raddeana	Pteridaceae
Cryptogramma_brunoniana	Pteridaceae
Cryptogramma_fumariifolia	Pteridaceae
Cryptogramma_stelleri	Pteridaceae
Coniogramme_gracilis	Pteridaceae
Coniogramme_japonica	Pteridaceae
Coniogramme_intermedia	Pteridaceae
Coniogramme_fraxinea	Pteridaceae
Coniogramme_wilsonii	Pteridaceae
Acrostichum_aureum	Pteridaceae
Acrostichum_speciosum	Pteridaceae
Acrostichum_danaeifolium	Pteridaceae
Ceratopteris_richardii	Pteridaceae
Ceratopteris_thalictroides	Pteridaceae
Ceratopteris_pteridoides	Pteridaceae
Polystichopsis_pubescens	Dryopteridaceae
Polystichopsis_muscosa	Dryopteridaceae
Polystichopsis_chaerophylloides	Dryopteridaceae
Cyclodium_trianae	Dryopteridaceae
Cyclodium_guianensis	Dryopteridaceae
Polybotrya_sessilisora	Dryopteridaceae
Polybotrya_andina	Dryopteridaceae
Polybotrya_fractiserialis	Dryopteridaceae
Polybotrya_alfredii	Dryopteridaceae
Polybotrya_pubens	Dryopteridaceae
Polybotrya_caudata	Dryopteridaceae
Maxonia_apiifolia	Dryopteridaceae
Olfersia_cervina	Dryopteridaceae
Phanerophlebia_nobilis	Dryopteridaceae
Phanerophlebia_umbonata	Dryopteridaceae
Phanerophlebia_juglandifolia	Dryopteridaceae
Cyrtomium_guizhouense	Dryopteridaceae
Cyrtomium_lonchitoides	Dryopteridaceae
Cyrtomium_macrophyllum	Dryopteridaceae
Cyrtomium_urophyllum	Dryopteridaceae
Cyrtomium_omeiense	Dryopteridaceae
Cyrtomium_caryotideum	Dryopteridaceae
Cyrtomium_yunnanense	Dryopteridaceae
Cyrtomium_grossum	Dryopteridaceae
Cyrtomium_chingianum	Dryopteridaceae
Cyrtomium_shingianum	Dryopteridaceae
Cyrtomium_nephrolepioides	Dryopteridaceae
Cyrtomium_pachyphyllum	Dryopteridaceae
Cyrtomium_hemionitis	Dryopteridaceae
Cyrtomium_aequibasis	Dryopteridaceae
Cyrtomium_laetevirens	Dryopteridaceae
Cyrtomium_fortunei	Dryopteridaceae
Cyrtomium_yamamotoi	Dryopteridaceae
Cyrtomium_devexiscapulae	Dryopteridaceae
Cyrtomium_falcatum	Dryopteridaceae
Polystichum_liui	Dryopteridaceae
Polystichum_thomsonii	Dryopteridaceae
Polystichum_erosum	Dryopteridaceae
Polystichum_craspedosorum	Dryopteridaceae
Polystichum_inaense	Dryopteridaceae
Polystichum_acutidens	Dryopteridaceae
Polystichum_imbricans	Dryopteridaceae
Polystichum_weimingii	Dryopteridaceae
Polystichum_munitum	Dryopteridaceae
Polystichum_setiferum	Dryopteridaceae
Polystichum_aculeatum	Dryopteridaceae
Polystichum_anomalum	Dryopteridaceae
Polystichum_eximium	Dryopteridaceae
Polystichum_tacticopterum	Dryopteridaceae
Polystichum_altum	Dryopteridaceae
Polystichum_lentum	Dryopteridaceae
Polystichum_chunii	Dryopteridaceae
Polystichum_attenuatum	Dryopteridaceae
Polystichum_semifertile	Dryopteridaceae
Polystichum_biaristatum	Dryopteridaceae
Polystichum_disjunctum	Dryopteridaceae
Polystichum_oreodoxa	Dryopteridaceae
Polystichum_fugongense	Dryopteridaceae
Polystichum_pycnopterum	Dryopteridaceae
Polystichum_longipinnulum	Dryopteridaceae
Polystichum_nepalense	Dryopteridaceae
Polystichum_grandifrons	Dryopteridaceae
Polystichum_lachenense	Dryopteridaceae
Polystichum_atkinsonii	Dryopteridaceae
Polystichum_stenophyllum	Dryopteridaceae
Polystichum_moupinense	Dryopteridaceae
Polystichum_longipaleatum	Dryopteridaceae
Polystichum_nudisorum	Dryopteridaceae
Polystichum_punctiferum	Dryopteridaceae
Polystichum_chingiae	Dryopteridaceae
Polystichum_crinigerum	Dryopteridaceae
Polystichum_lichiangense	Dryopteridaceae
Sorolepidium_ovale	Dryopteridaceae
Polystichum_duthiei	Dryopteridaceae
Polystichum_neozelandicum	Dryopteridaceae
Polystichum_bonseyi	Dryopteridaceae
Polystichum_nigrum	Dryopteridaceae
Polystichum_haleakalense	Dryopteridaceae
Polystichum_wilsonii	Dryopteridaceae
Polystichum_yunnanense	Dryopteridaceae
Polystichum_jizhushanense	Dryopteridaceae
Polystichum_discretum	Dryopteridaceae
Polystichum_makinoi	Dryopteridaceae
Polystichum_piceopaleaceum	Dryopteridaceae
Polystichum_gongboense	Dryopteridaceae
Polystichum_tagawanum	Dryopteridaceae
Polystichum_otomasui	Dryopteridaceae
Polystichum_pseudomakinoi	Dryopteridaceae
Polystichum_shimurae	Dryopteridaceae
Polystichum_ohmurae	Dryopteridaceae
Polystichum_longifrons	Dryopteridaceae
Polystichum_fibrillosopaleaceum	Dryopteridaceae
Polystichum_igaense	Dryopteridaceae
Polystichum_obae	Dryopteridaceae
Polystichum_retrosopaleaceum	Dryopteridaceae
Polystichum_polyblepharum	Dryopteridaceae
Polystichum_setigerum	Dryopteridaceae
Polystichum_braunii	Dryopteridaceae
Polystichum_andersonii	Dryopteridaceae
Polystichum_cystostegia	Dryopteridaceae
Polystichum_oculatum	Dryopteridaceae
Polystichum_silvaticum	Dryopteridaceae
Polystichum_wawranum	Dryopteridaceae
Polystichum_australiense	Dryopteridaceae
Polystichum_moorei	Dryopteridaceae
Polystichum_whiteleggei	Dryopteridaceae
Polystichum_proliferum	Dryopteridaceae
Polystichum_vestitum	Dryopteridaceae
Polystichum_formosum	Dryopteridaceae
Polystichum_fallax	Dryopteridaceae
Polystichum_ekmanii	Dryopteridaceae
Polystichum_fournieri	Dryopteridaceae
Polystichum_platyphyllum	Dryopteridaceae
Polystichum_brachypterum	Dryopteridaceae
Polystichum_stimulans	Dryopteridaceae
Polystichum_neolobatum	Dryopteridaceae
Polystichum_latilepis	Dryopteridaceae
Polystichum_revolutum	Dryopteridaceae
Polystichum_xiphophyllum	Dryopteridaceae
Polystichum_herbaceum	Dryopteridaceae
Polystichum_parvifoliolatum	Dryopteridaceae
Polystichum_tsus_simense	Dryopteridaceae
Polystichum_sinotsus_simense	Dryopteridaceae
Polystichum_luctuosum	Dryopteridaceae
Polystichum_hancockii	Dryopteridaceae
Polystichum_tripteron	Dryopteridaceae
Polystichum_yaeyamense	Dryopteridaceae
Polystichum_cavernicola	Dryopteridaceae
Polystichum_minutissimum	Dryopteridaceae
Polystichum_fengshanense	Dryopteridaceae
Polystichum_speluncicola	Dryopteridaceae
Polystichum_puteicola	Dryopteridaceae
Polystichum_hookerianum	Dryopteridaceae
Polystichum_balansae	Dryopteridaceae
Polystichum_uniseriale	Dryopteridaceae
Polystichum_formosanum	Dryopteridaceae
Polystichum_subacutidens	Dryopteridaceae
Polystichum_dielsii	Dryopteridaceae
Polystichum_yuanum	Dryopteridaceae
Polystichum_deltodon	Dryopteridaceae
Polystichum_tenuius	Dryopteridaceae
Polystichum_xichouense	Dryopteridaceae
Polystichum_minimum	Dryopteridaceae
Polystichum_fraxinellum	Dryopteridaceae
Polystichum_christii	Dryopteridaceae
Polystichum_auriculum	Dryopteridaceae
Polystichum_omeiense	Dryopteridaceae
Polystichum_tonkinense	Dryopteridaceae
Polystichum_obliquum	Dryopteridaceae
Polystichum_conjunctum	Dryopteridaceae
Polystichum_putuoense	Dryopteridaceae
Polystichum_lepidocaulon	Dryopteridaceae
Polystichum_basipinnatum	Dryopteridaceae
Polystichum_squarrosum	Dryopteridaceae
Polystichum_hillebrandii	Dryopteridaceae
Polystichum_rigens	Dryopteridaceae
Polystichum_lonchitis	Dryopteridaceae
Polystichum_speciosissimum	Dryopteridaceae
Polystichum_alfaroi	Dryopteridaceae
Polystichum_concinnum	Dryopteridaceae
Polystichum_talamancanum	Dryopteridaceae
Polystichum_turrialbae	Dryopteridaceae
Polystichum_muricatum	Dryopteridaceae
Polystichum_hartwegii	Dryopteridaceae
Polystichum_stuebelii	Dryopteridaceae
Polystichum_lehmannii	Dryopteridaceae
Polystichum_amboroense	Dryopteridaceae
Polystichum_dubium	Dryopteridaceae
Polystichum_bulbiferum	Dryopteridaceae
Polystichum_albomarginatum	Dryopteridaceae
Polystichum_montevidense	Dryopteridaceae
Polystichum_nudicaule	Dryopteridaceae
Polystichum_rochaleanum	Dryopteridaceae
Polystichum_maximum	Dryopteridaceae
Polystichum_pycnolepis	Dryopteridaceae
Polystichum_lepidotum	Dryopteridaceae
Polystichum_sodiroi	Dryopteridaceae
Polystichum_gelidum	Dryopteridaceae
Polystichum_polyphyllum	Dryopteridaceae
Polystichum_orbiculatum	Dryopteridaceae
Polystichum_rhizophyllum	Dryopteridaceae
Polystichum_underwoodii	Dryopteridaceae
Polystichum_glandulosum	Dryopteridaceae
Polystichum_drepanum	Dryopteridaceae
Polystichum_rapense	Dryopteridaceae
Polystichum_holttumii	Dryopteridaceae
Polystichum_marquesense	Dryopteridaceae
Polystichum_horizontale	Dryopteridaceae
Polystichum_ammifolium	Dryopteridaceae
Polystichum_dudleyi	Dryopteridaceae
Polystichum_scopulinum	Dryopteridaceae
Polystichum_lemmonii	Dryopteridaceae
Polystichum_acrostichoides	Dryopteridaceae
Polystichum_mohrioides	Dryopteridaceae
Polystichum_dracomontanum	Dryopteridaceae
Polystichum_transkeiense	Dryopteridaceae
Polystichum_pungens	Dryopteridaceae
Polystichum_macleae	Dryopteridaceae
Polystichum_prescottianum	Dryopteridaceae
Sorolepidium_glaciale	Dryopteridaceae
Polystichum_bakerianum	Dryopteridaceae
Polystichum_falcinellum	Dryopteridaceae
Polystichum_kungianum	Dryopteridaceae
Polystichum_capillipes	Dryopteridaceae
Ctenitis_rhodolepis	Dryopteridaceae
Ctenitis_subglandulosa	Dryopteridaceae
Ctenitis_lepigera	Dryopteridaceae
Ctenitis_yunnanensis	Dryopteridaceae
Ctenitis_eatonii	Dryopteridaceae
Ctenitis_iriomotensis	Dryopteridaceae
Ctenitis_microlepigera	Dryopteridaceae
Ctenitis_decurrentipinnata	Dryopteridaceae
Ataxipteris_sinii	Dryopteridaceae
Ctenitis_refulgens	Dryopteridaceae
Ctenitis_submarginalis	Dryopteridaceae
Ctenitis_maritima	Dryopteridaceae
Ctenitis_humida	Dryopteridaceae
Ctenitis_cirrhosa	Dryopteridaceae
Ctenitis_borbonica	Dryopteridaceae
Ctenitis_crinita	Dryopteridaceae
Ctenitis_cyclochlamys	Dryopteridaceae
Ctenitis_desvauxii	Dryopteridaceae
Heterogonium_sieberianum	Tectariaceae
Pseudotectaria_biformis	Dryopteridaceae
Pseudotectaria_fibrillosa	Dryopteridaceae
Pseudotectaria_decaryana	Dryopteridaceae
Ctenitis_sloanei	Dryopteridaceae
Stigmatopteris_ichthiosma	Dryopteridaceae
Stigmatopteris_killipiana	Dryopteridaceae
Stigmatopteris_sordida	Dryopteridaceae
Stigmatopteris_lechleri	Dryopteridaceae
Stigmatopteris_longicaudata	Dryopteridaceae
Dryopteris_redactopinnata	Dryopteridaceae
Dryopteris_chrysocoma	Dryopteridaceae
Dryopteris_alpestris	Dryopteridaceae
Dryopteris_inaequalis	Dryopteridaceae
Dryopteris_bernieri	Dryopteridaceae
Dryopteris_aquilinoides	Dryopteridaceae
Dryopteris_athamantica	Dryopteridaceae
Dryopteris_pentheri	Dryopteridaceae
Dryopteris_cochleata	Dryopteridaceae
Dryopteris_marginata	Dryopteridaceae
Dryopteris_barbigera	Dryopteridaceae
Dryopteris_goeringiana	Dryopteridaceae
Dryopteris_stewartii	Dryopteridaceae
Dryopteris_juxtaposita	Dryopteridaceae
Dryopteris_pseudovaria	Dryopteridaceae
Dryopteris_rubrobrunnea	Dryopteridaceae
Dryopteris_basisora	Dryopteridaceae
Dryopteris_komarovii	Dryopteridaceae
Dryopteris_marginalis	Dryopteridaceae
Dryopteris_affinis	Dryopteridaceae
Dryopteris_pseudofilix_mas	Dryopteridaceae
Dryopteris_caucasica	Dryopteridaceae
Dryopteris_abbreviata	Dryopteridaceae
Dryopteris_oreades	Dryopteridaceae
Dryopteris_ardechensis	Dryopteridaceae
Dryopteris_filix_mas	Dryopteridaceae
Dryopteris_lepidopoda	Dryopteridaceae
Dryopteris_sichotensis	Dryopteridaceae
Dryopteris_coreanomontana	Dryopteridaceae
Dryopteris_sublacera	Dryopteridaceae
Dryopteris_lacera	Dryopteridaceae
Dryopteris_neolacera	Dryopteridaceae
Dryopteris_bodinieri	Dryopteridaceae
Dryopteris_sieboldii	Dryopteridaceae
Dryopteris_lachoongensis	Dryopteridaceae
Dryopteris_costalisora	Dryopteridaceae
Dryopteris_panda	Dryopteridaceae
Dryopteris_reflexosquamata	Dryopteridaceae
Dryopteris_wallichiana	Dryopteridaceae
Dryopteris_borreri	Dryopteridaceae
Dryopteris_subbipinnata	Dryopteridaceae
Dryopteris_triangularis	Dryopteridaceae
Dryopteris_crassirhizoma	Dryopteridaceae
Dryopteris_subpycnopteroides	Dryopteridaceae
Dryopteris_anthracinisquama	Dryopteridaceae
Dryopteris_scottii	Dryopteridaceae
Dryopteris_cycadina	Dryopteridaceae
Dryopteris_stenolepis	Dryopteridaceae
Dryopteris_dickinsii	Dryopteridaceae
Dryopteris_tsutsuiana	Dryopteridaceae
Dryopteris_handeliana	Dryopteridaceae
Dryopteris_lunanensis	Dryopteridaceae
Dryopteris_gamblei	Dryopteridaceae
Dryopteris_hangchowensis	Dryopteridaceae
Dryopteris_commixta	Dryopteridaceae
Dryopteris_uniformis	Dryopteridaceae
Dryopteris_atrata	Dryopteridaceae
Dryopteris_fatuhivensis	Dryopteridaceae
Dryopteris_pycnopteroides	Dryopteridaceae
Dryopteris_namegatae	Dryopteridaceae
Dryopteris_liankwangensis	Dryopteridaceae
Dryopteris_rosthornii	Dryopteridaceae
Dryopteris_polylepis	Dryopteridaceae
Dryopteris_sinofibrillosa	Dryopteridaceae
Dryopteris_himachalensis	Dryopteridaceae
Dryopteris_silaensis	Dryopteridaceae
Dryopteris_conjugata	Dryopteridaceae
Dryopteris_arguta	Dryopteridaceae
Dryopteris_laeta	Dryopteridaceae
Dryopteris_shiroumensis	Dryopteridaceae
Dryopteris_fragrans	Dryopteridaceae
Dryopteris_maximowiczii	Dryopteridaceae
Dryopteris_sinosparsa	Dryopteridaceae
Dryopteris_melanocarpa	Dryopteridaceae
Dryopteris_hayatae	Dryopteridaceae
Dryopteris_sparsa	Dryopteridaceae
Dryopteris_subexaltata	Dryopteridaceae
Dryopteris_sabae	Dryopteridaceae
Dryopteris_yakusilvicola	Dryopteridaceae
Dryopteris_hondoensis	Dryopteridaceae
Dryopsis_maximowicziana	Dryopteridaceae
Dryopteris_monticola	Dryopteridaceae
Dryopteris_goldieana	Dryopteridaceae
Dryopteris_pallida	Dryopteridaceae
Dryopteris_submontana	Dryopteridaceae
Dryopteris_oligodonta	Dryopteridaceae
Dryopteris_odontoloma	Dryopteridaceae
Dryopteris_aitoniana	Dryopteridaceae
Dryopteris_ludoviciana	Dryopteridaceae
Dryopteris_celsa	Dryopteridaceae
Dryopteris_tokyoensis	Dryopteridaceae
Dryopteris_tetrapinnata	Dryopteridaceae
Dryopteris_sandwicensis	Dryopteridaceae
Dryopteris_crinalis	Dryopteridaceae
Dryopteris_mauiensis	Dryopteridaceae
Dryopteris_munchii	Dryopteridaceae
Dryopteris_spinosa	Dryopteridaceae
Dryopteris_carthusiana	Dryopteridaceae
Dryopteris_remota	Dryopteridaceae
Dryopteris_clintoniana	Dryopteridaceae
Dryopteris_cristata	Dryopteridaceae
Dryopteris_expansa	Dryopteridaceae
Dryopteris_assimilis	Dryopteridaceae
Dryopteris_austriaca	Dryopteridaceae
Dryopteris_dilatata	Dryopteridaceae
Dryopteris_amurensis	Dryopteridaceae
Dryopteris_antarctica	Dryopteridaceae
Dryopteris_crispifolia	Dryopteridaceae
Dryopteris_azorica	Dryopteridaceae
Dryopteris_intermedia	Dryopteridaceae
Dryopteris_campyloptera	Dryopteridaceae
Dryopsis_mariformis	Dryopteridaceae
Dryopsis_heterolaena	Dryopteridaceae
Dryopsis_nidus	Dryopteridaceae
Dryopsis_clarkei	Dryopteridaceae
Dryopsis_apiciflora	Dryopteridaceae
Dryopteris_cyclopeltidiformis	Dryopteridaceae
Dryopteris_gymnophylla	Dryopteridaceae
Dryopteris_diffracta	Dryopteridaceae
Dryopteris_hasseltii	Dryopteridaceae
Dryopteris_subreflexipinna	Dryopteridaceae
Dryopteris_polita	Dryopteridaceae
Dryopteris_kobayashii	Dryopteridaceae
Dryopteris_chinensis	Dryopteridaceae
Dryopteris_sordidipes	Dryopteridaceae
Dryopteris_dehuaensis	Dryopteridaceae
Dryopteris_hadanoi	Dryopteridaceae
Dryopteris_gushanica	Dryopteridaceae
Dryopteris_saxifraga	Dryopteridaceae
Dryopteris_saxifragivaria	Dryopteridaceae
Dryopteris_sacrosancta	Dryopteridaceae
Dryopteris_varia	Dryopteridaceae
Dryopteris_bissetiana	Dryopteridaceae
Dryopteris_setosa	Dryopteridaceae
Dryopteris_erythrosora	Dryopteridaceae
Dryopteris_podophylla	Dryopteridaceae
Dryopteris_ryo_itoana	Dryopteridaceae
Dryopteris_submarginata	Dryopteridaceae
Dryopteris_pseudosparsa	Dryopteridaceae
Dryopteris_anadroma	Dryopteridaceae
Dryopteris_gymnosora	Dryopteridaceae
Dryopteris_tsugiwoi	Dryopteridaceae
Dryopteris_fuscipes	Dryopteridaceae
Dryopteris_medioxima	Dryopteridaceae
Dryopteris_shibipedis	Dryopteridaceae
Dryopteris_championii	Dryopteridaceae
Dryopteris_tsoongii	Dryopteridaceae
Dryopteris_kinkiensis	Dryopteridaceae
Dryopteris_lepidorachis	Dryopteridaceae
Dryopteris_indusiata	Dryopteridaceae
Dryopteris_nipponensis	Dryopteridaceae
Dryopteris_caudipinna	Dryopteridaceae
Dryopteris_koidzumiana	Dryopteridaceae
Dryopteris_cystolepidota	Dryopteridaceae
Dryopteris_wattsii	Dryopteridaceae
Dryopteris_formosana	Dryopteridaceae
Dryopteris_guanchica	Dryopteridaceae
Dryopteris_corleyi	Dryopteridaceae
Dryopteris_aemula	Dryopteridaceae
Dryopteris_hawaiiensis	Dryopteridaceae
Dryopteris_pacifica	Dryopteridaceae
Dryopteris_labordei	Dryopteridaceae
Dryopteris_integriloba	Dryopteridaceae
Dryopteris_kinokuniensis	Dryopteridaceae
Dryopteris_parafuscipes	Dryopteridaceae
Dryopteris_decipiens	Dryopteridaceae
Dryopteris_paraerythrosora	Dryopteridaceae
Diacalpe_aspidioides	Dryopteridaceae
Diacalpe_christensenae	Dryopteridaceae
Diacalpe_chinensis	Dryopteridaceae
Dryopteris_squamifera	Dryopteridaceae
Acrophorus_stipellatus	Dryopteridaceae
Acrophorus_emeiensis	Dryopteridaceae
Acrophorus_exstipellatus	Dryopteridaceae
Acrophorus_nodosus	Dryopteridaceae
Dryopteris_rubiginosa	Dryopteridaceae
Diacalpe_annamensis	Dryopteridaceae
Dryopteris_squamiseta	Dryopteridaceae
Dryopteris_hendersonii	Dryopteridaceae
Dryopteris_shikokiana	Dryopteridaceae
Peranema_cyatheoides	Dryopteridaceae
Peranema_luzonicum	Dryopteridaceae
Dryopteris_huberi	Dryopteridaceae
Dryopteris_salvinii	Dryopteridaceae
Dryopteris_flaccisquama	Dryopteridaceae
Dryopteris_saffordii	Dryopteridaceae
Dryopteris_cinnamomea	Dryopteridaceae
Dryopteris_simplicior	Dryopteridaceae
Dryopteris_patula	Dryopteridaceae
Dryopteris_rosea	Dryopteridaceae
Dryopteris_knoblochii	Dryopteridaceae
Dryopteris_rossii	Dryopteridaceae
Dryopteris_sororia	Dryopteridaceae
Dryopteris_maxonii	Dryopteridaceae
Dryopteris_futura	Dryopteridaceae
Dryopteris_nubigena	Dryopteridaceae
Dryopteris_karwinskyana	Dryopteridaceae
Arachniodes_mutica	Dryopteridaceae
Arachniodes_rhomboidea	Dryopteridaceae
Arachniodes_assamica	Dryopteridaceae
Arachniodes_centrochinensis	Dryopteridaceae
Phanerophlebiopsis_duplicatoserrata	Dryopteridaceae
Arachniodes_yoshinagae	Dryopteridaceae
Phanerophlebiopsis_bipinnata	Dryopteridaceae
Arachniodes_fengii	Dryopteridaceae
Arachniodes_tonkinensis	Dryopteridaceae
Arachniodes_hekiana	Dryopteridaceae
Arachniodes_cantilenae	Dryopteridaceae
Arachniodes_hiugana	Dryopteridaceae
Arachniodes_nipponica	Dryopteridaceae
Arachniodes_denticulata	Dryopteridaceae
Arachniodes_cavaleriei	Dryopteridaceae
Arachniodes_gigantea	Dryopteridaceae
Arachniodes_pseudocavalerii	Dryopteridaceae
Arachniodes_globisora	Dryopteridaceae
Arachniodes_aristata	Dryopteridaceae
Arachniodes_yasu_inouei	Dryopteridaceae
Arachniodes_simplicior	Dryopteridaceae
Dryopteris_hwangii	Dryopteridaceae
Dryopteris_caudifrons	Dryopteridaceae
Arachniodes_oohorae	Dryopteridaceae
Arachniodes_chinensis	Dryopteridaceae
Arachniodes_caudata	Dryopteridaceae
Phanerophlebiopsis_neopodophylla	Dryopteridaceae
Arachniodes_setifera	Dryopteridaceae
Arachniodes_dimorphophylla	Dryopteridaceae
Arachniodes_davalliiformis	Dryopteridaceae
Arachniodes_sporadosora	Dryopteridaceae
Arachniodes_speciosa	Dryopteridaceae
Arachniodes_festina	Dryopteridaceae
Arachniodes_standishii	Dryopteridaceae
Arachniodes_amoena	Dryopteridaceae
Arachniodes_borealis	Dryopteridaceae
Arachniodes_miqueliana	Dryopteridaceae
Arachniodes_maximowiczii	Dryopteridaceae
Leptorumohra_quadripinnata	Dryopteridaceae
Arachniodes_sinomiqueliana	Dryopteridaceae
Parapolystichum_tinarooense	Dryopteridaceae
Parapolystichum_acuminatum	Dryopteridaceae
Parapolystichum_rufescens	Dryopteridaceae
Parapolystichum_munitum	Dryopteridaceae
Parapolystichum_windsorensis	Dryopteridaceae
Parapolystichum_glabellum	Dryopteridaceae
Parapolystichum_smithianum	Dryopteridaceae
Parapolystichum_microsorum	Dryopteridaceae
Parapolystichum_acutum	Dryopteridaceae
Parapolystichum_effusum	Dryopteridaceae
Parapolystichum_confine	Dryopteridaceae
Parapolystichum_barterianum	Dryopteridaceae
Parapolystichum_boivinii	Dryopteridaceae
Parapolystichum_pseudoperrierianum	Dryopteridaceae
Parapolystichum_perrierianum	Dryopteridaceae
Parapolystichum_nigritianum	Dryopteridaceae
Parapolystichum_vogelii	Dryopteridaceae
Parapolystichum_subsimile	Dryopteridaceae
Parapolystichum_currorii	Dryopteridaceae
Megalastrum_lanuginosum	Dryopteridaceae
Megalastrum_abundans	Dryopteridaceae
Megalastrum_vastum	Dryopteridaceae
Megalastrum_biseriale	Dryopteridaceae
Megalastrum_subincisum	Dryopteridaceae
Megalastrum_macrotheca	Dryopteridaceae
Megalastrum_atrogriseum	Dryopteridaceae
Megalastrum_oppositum	Dryopteridaceae
Megalastrum_lanatum	Dryopteridaceae
Megalastrum_canacae	Dryopteridaceae
Rumohra_adiantiformis	Dryopteridaceae
Rumohra_berteroana	Dryopteridaceae
Lastreopsis_decomposita	Dryopteridaceae
Lastreopsis_tenera	Dryopteridaceae
Lastreopsis_silvestris	Dryopteridaceae
Lastreopsis_marginans	Dryopteridaceae
Lastreopsis_walleri	Dryopteridaceae
Lastreopsis_subrecedens	Dryopteridaceae
Lastreopsis_poecilophlebia	Dryopteridaceae
Lastreopsis_wurunuran	Dryopteridaceae
Lastreopsis_tripinnata	Dryopteridaceae
Lastreopsis_subsericea	Dryopteridaceae
Lastreopsis_hispida	Dryopteridaceae
Lastreopsis_amplissima	Dryopteridaceae
Parapolystichum_killipii	Dryopteridaceae
Mickelia_guianensis	Dryopteridaceae
Mickelia_scandens	Dryopteridaceae
Mickelia_bernoullii	Dryopteridaceae
Mickelia_oligarchica	Dryopteridaceae
Mickelia_hemiotis	Dryopteridaceae
Mickelia_pergamentacea	Dryopteridaceae
Mickelia_nicotianifolia	Dryopteridaceae
Bolbitis_acrostichoides	Dryopteridaceae
Bolbitis_serratifolia	Dryopteridaceae
Bolbitis_salicina	Dryopteridaceae
Bolbitis_angustipinna	Dryopteridaceae
Bolbitis_crispatula	Dryopteridaceae
Bolbitis_tibetica	Dryopteridaceae
Bolbitis_sinuata	Dryopteridaceae
Bolbitis_subcordata	Dryopteridaceae
Bolbitis_appendiculata	Dryopteridaceae
Bolbitis_quoyana	Dryopteridaceae
Bolbitis_lonchophora	Dryopteridaceae
Bolbitis_major	Dryopteridaceae
Bolbitis_portoricensis	Dryopteridaceae
Bolbitis_humblotii	Dryopteridaceae
Bolbitis_bipinnatifida	Dryopteridaceae
Bolbitis_fluviatilis	Dryopteridaceae
Bolbitis_semipinnatifida	Dryopteridaceae
Bolbitis_aliena	Dryopteridaceae
Bolbitis_heudelotii	Dryopteridaceae
Bolbitis_gemmifera	Dryopteridaceae
Lomagramma_pteroides	Dryopteridaceae
Lomagramma_cordipinna	Dryopteridaceae
Lomagramma_lomarioides	Dryopteridaceae
Lomagramma_matthewii	Dryopteridaceae
Lomagramma_sumatrana	Dryopteridaceae
Lomagramma_sinuata	Dryopteridaceae
Lomagramma_brooksii	Dryopteridaceae
Lomagramma_perakensis	Dryopteridaceae
Arthrobotrya_wilkesiana	Dryopteridaceae
Arthrobotrya_articulata	Dryopteridaceae
Teratophyllum_ludens	Dryopteridaceae
Teratophyllum_rotundifoliatum	Dryopteridaceae
Teratophyllum_koordersii	Dryopteridaceae
Elaphoglossum_wrightii	Dryopteridaceae
Elaphoglossum_aemulum	Dryopteridaceae
Elaphoglossum_crassifolium	Dryopteridaceae
Elaphoglossum_mcclurei	Dryopteridaceae
Elaphoglossum_moranii	Dryopteridaceae
Elaphoglossum_mitorrhizum	Dryopteridaceae
Elaphoglossum_guentheri	Dryopteridaceae
Elaphoglossum_lingua	Dryopteridaceae
Elaphoglossum_firmum	Dryopteridaceae
Elaphoglossum_cardiophyllum	Dryopteridaceae
Elaphoglossum_conspersum	Dryopteridaceae
Elaphoglossum_ovalilimbatum	Dryopteridaceae
Elaphoglossum_conforme	Dryopteridaceae
Elaphoglossum_wawrae	Dryopteridaceae
Elaphoglossum_glabellum	Dryopteridaceae
Elaphoglossum_coursii	Dryopteridaceae
Elaphoglossum_coriaceum	Dryopteridaceae
Elaphoglossum_martinicense	Dryopteridaceae
Elaphoglossum_affine	Dryopteridaceae
Elaphoglossum_angulatum	Dryopteridaceae
Elaphoglossum_acrostichoides	Dryopteridaceae
Elaphoglossum_minutum	Dryopteridaceae
Elaphoglossum_lastii	Dryopteridaceae
Elaphoglossum_christianeae	Dryopteridaceae
Elaphoglossum_herminieri	Dryopteridaceae
Elaphoglossum_doanense	Dryopteridaceae
Elaphoglossum_maxonii	Dryopteridaceae
Elaphoglossum_metallicum	Dryopteridaceae
Elaphoglossum_yoshinagae	Dryopteridaceae
Elaphoglossum_tosaense	Dryopteridaceae
Elaphoglossum_malgassicum	Dryopteridaceae
Elaphoglossum_sieberi	Dryopteridaceae
Elaphoglossum_macropodium	Dryopteridaceae
Elaphoglossum_vieillardii	Dryopteridaceae
Elaphoglossum_guatemalense	Dryopteridaceae
Elaphoglossum_sartorii	Dryopteridaceae
Elaphoglossum_cismense	Dryopteridaceae
Elaphoglossum_croatii	Dryopteridaceae
Elaphoglossum_biolleyi	Dryopteridaceae
Elaphoglossum_delgadilloanum	Dryopteridaceae
Elaphoglossum_variabile	Dryopteridaceae
Elaphoglossum_andicola	Dryopteridaceae
Elaphoglossum_subsessile	Dryopteridaceae
Elaphoglossum_lepervanchii	Dryopteridaceae
Elaphoglossum_luridum	Dryopteridaceae
Elaphoglossum_marquisearum	Dryopteridaceae
Elaphoglossum_pteropus	Dryopteridaceae
Elaphoglossum_hornei	Dryopteridaceae
Elaphoglossum_flaccidum	Dryopteridaceae
Elaphoglossum_alismifolium	Dryopteridaceae
Elaphoglossum_lechlerianum	Dryopteridaceae
Elaphoglossum_longistipitatum	Dryopteridaceae
Elaphoglossum_callifolium	Dryopteridaceae
Elaphoglossum_productum	Dryopteridaceae
Elaphoglossum_grayumii	Dryopteridaceae
Elaphoglossum_hoffmanii	Dryopteridaceae
Elaphoglossum_decaryanum	Dryopteridaceae
Elaphoglossum_latifolium	Dryopteridaceae
Elaphoglossum_glaucum	Dryopteridaceae
Elaphoglossum_nidusoides	Dryopteridaceae
Elaphoglossum_marojejyense	Dryopteridaceae
Elaphoglossum_nidiforme	Dryopteridaceae
Elaphoglossum_nidiformis	Dryopteridaceae
Elaphoglossum_peltatum	Dryopteridaceae
Elaphoglossum_tripartitum	Dryopteridaceae
Elaphoglossum_rhomboideum	Dryopteridaceae
Elaphoglossum_deltoideum	Dryopteridaceae
Elaphoglossum_blepharis	Dryopteridaceae
Elaphoglossum_columbianum	Dryopteridaceae
Elaphoglossum_anthracinum	Dryopteridaceae
Elaphoglossum_bryogenes	Dryopteridaceae
Elaphoglossum_squamipes	Dryopteridaceae
Elaphoglossum_feei	Dryopteridaceae
Elaphoglossum_lloense	Dryopteridaceae
Elaphoglossum_concinnum	Dryopteridaceae
Elaphoglossum_andreanum	Dryopteridaceae
Elaphoglossum_moorei	Dryopteridaceae
Elaphoglossum_craspedariiforme	Dryopteridaceae
Elaphoglossum_piloselloides	Dryopteridaceae
Elaphoglossum_spatulatum	Dryopteridaceae
Elaphoglossum_boryanum	Dryopteridaceae
Elaphoglossum_phoras	Dryopteridaceae
Elaphoglossum_cardenasii	Dryopteridaceae
Elaphoglossum_russelliae	Dryopteridaceae
Elaphoglossum_squarrosum	Dryopteridaceae
Elaphoglossum_davidsei	Dryopteridaceae
Elaphoglossum_aubertii	Dryopteridaceae
Elaphoglossum_eximium	Dryopteridaceae
Elaphoglossum_setigerum	Dryopteridaceae
Elaphoglossum_ocoense	Dryopteridaceae
Elaphoglossum_lindenii	Dryopteridaceae
Elaphoglossum_pilosius	Dryopteridaceae
Elaphoglossum_samoense	Dryopteridaceae
Elaphoglossum_meyeri	Dryopteridaceae
Elaphoglossum_rapense	Dryopteridaceae
Elaphoglossum_fournierianum	Dryopteridaceae
Elaphoglossum_smithii	Dryopteridaceae
Elaphoglossum_pygmaeum	Dryopteridaceae
Elaphoglossum_papillosum	Dryopteridaceae
Elaphoglossum_pusillum	Dryopteridaceae
Elaphoglossum_minutissimum	Dryopteridaceae
Elaphoglossum_costaricense	Dryopteridaceae
Elaphoglossum_siliquoides	Dryopteridaceae
Elaphoglossum_oblanceolatum	Dryopteridaceae
Elaphoglossum_phanerophlebium	Dryopteridaceae
Elaphoglossum_cubense	Dryopteridaceae
Elaphoglossum_alvaradoanum	Dryopteridaceae
Elaphoglossum_apodum	Dryopteridaceae
Elaphoglossum_auripilum	Dryopteridaceae
Elaphoglossum_backhousianum	Dryopteridaceae
Elaphoglossum_gomezianum	Dryopteridaceae
Elaphoglossum_erinaceum	Dryopteridaceae
Elaphoglossum_hybridum	Dryopteridaceae
Elaphoglossum_lonchophyllum	Dryopteridaceae
Elaphoglossum_crinitum	Dryopteridaceae
Elaphoglossum_decoratum	Dryopteridaceae
Elaphoglossum_prestonii	Dryopteridaceae
Elaphoglossum_wacketii	Dryopteridaceae
Elaphoglossum_tomentosum	Dryopteridaceae
Elaphoglossum_lanatum	Dryopteridaceae
Elaphoglossum_richardii	Dryopteridaceae
Elaphoglossum_heterolepis	Dryopteridaceae
Elaphoglossum_humbertii	Dryopteridaceae
Elaphoglossum_scolopendriforme	Dryopteridaceae
Elaphoglossum_achroalepis	Dryopteridaceae
Elaphoglossum_forsythii_majoris	Dryopteridaceae
Elaphoglossum_avaratraense	Dryopteridaceae
Elaphoglossum_ciliatum	Dryopteridaceae
Elaphoglossum_nigrescens	Dryopteridaceae
Elaphoglossum_huacsaro	Dryopteridaceae
Elaphoglossum_bellermannianum	Dryopteridaceae
Elaphoglossum_engelii	Dryopteridaceae
Elaphoglossum_lehmannianum	Dryopteridaceae
Elaphoglossum_vulcanicum	Dryopteridaceae
Elaphoglossum_petiolosum	Dryopteridaceae
Elaphoglossum_deckenii	Dryopteridaceae
Elaphoglossum_semicylindricum	Dryopteridaceae
Elaphoglossum_leucolepis	Dryopteridaceae
Elaphoglossum_poolii	Dryopteridaceae
Elaphoglossum_orbignyanum	Dryopteridaceae
Elaphoglossum_auricomum	Dryopteridaceae
Elaphoglossum_vestitum	Dryopteridaceae
Elaphoglossum_eggersii	Dryopteridaceae
Elaphoglossum_furfuraceum	Dryopteridaceae
Elaphoglossum_bifurcatum	Dryopteridaceae
Elaphoglossum_dimorphum	Dryopteridaceae
Elaphoglossum_nervosum	Dryopteridaceae
Elaphoglossum_burchellii	Dryopteridaceae
Elaphoglossum_palmeri	Dryopteridaceae
Elaphoglossum_dussii	Dryopteridaceae
Elaphoglossum_gramineum	Dryopteridaceae
Elaphoglossum_ovatum	Dryopteridaceae
Elaphoglossum_tenuiculum	Dryopteridaceae
Elaphoglossum_edwallii	Dryopteridaceae
Elaphoglossum_caricifolium	Dryopteridaceae
Elaphoglossum_tectum	Dryopteridaceae
Elaphoglossum_lancifolium	Dryopteridaceae
Elaphoglossum_yungense	Dryopteridaceae
Elaphoglossum_killipii	Dryopteridaceae
Elaphoglossum_welwitschii	Dryopteridaceae
Elaphoglossum_ipshookense	Dryopteridaceae
Elaphoglossum_subcinnamomeum	Dryopteridaceae
Elaphoglossum_randii	Dryopteridaceae
Elaphoglossum_dendricola	Dryopteridaceae
Elaphoglossum_stipitatum	Dryopteridaceae
Elaphoglossum_petiolatum	Dryopteridaceae
Elaphoglossum_potosianum	Dryopteridaceae
Elaphoglossum_pringlei	Dryopteridaceae
Elaphoglossum_rzedowskii	Dryopteridaceae
Elaphoglossum_nigrocostatum	Dryopteridaceae
Elaphoglossum_austromarquesense	Dryopteridaceae
Elaphoglossum_paleaceum	Dryopteridaceae
Elaphoglossum_micropogon	Dryopteridaceae
Elaphoglossum_asterolepis	Dryopteridaceae
Elaphoglossum_rufidulum	Dryopteridaceae
Elaphoglossum_splendens	Dryopteridaceae
Elaphoglossum_cuspidatum	Dryopteridaceae
Elaphoglossum_succisifolium	Dryopteridaceae
Elaphoglossum_amygdalifolium	Dryopteridaceae
Pleocnemia_conjugata	Dryopteridaceae
Pleocnemia_hemiteliiformis	Dryopteridaceae
Pleocnemia_irregularis	Dryopteridaceae
Pleocnemia_leuzeana	Dryopteridaceae
Pleocnemia_cumingiana	Dryopteridaceae
Pleocnemia_dahlii	Dryopteridaceae
Pleocnemia_winitii	Dryopteridaceae
Pleocnemia_rufinervis	Dryopteridaceae
Pleocnemia_presliana	Dryopteridaceae
Pleocnemia_olivacea	Dryopteridaceae
Tectaria_impressa	Tectariaceae
Tectaria_luchunensis	Tectariaceae
Tectaria_simonsii	Tectariaceae
Tectaria_subtriphylla	Tectariaceae
Tectaria_subvariolosa	Tectariaceae
Tectaria_puberula	Tectariaceae
Tectaria_grossedentata	Tectariaceae
Tectaria_devexa	Tectariaceae
Cionidium_moorei	Tectariaceae
Tectaria_decurrens	Tectariaceae
Tectaria_apiifolia	Tectariaceae
Tectaria_dilacerata	Tectariaceae
Tectaria_heracleifolia	Tectariaceae
Tectaria_darienensis	Tectariaceae
Tectaria_vivipara	Tectariaceae
Tectaria_antioquoiana	Tectariaceae
Tectaria_pubens	Tectariaceae
Tectaria_acerifolia	Tectariaceae
Tectaria_trifoliata	Tectariaceae
Tectaria_panamensis	Tectariaceae
Tectaria_cicutaria	Tectariaceae
Tectaria_fimbriata	Tectariaceae
Tectaria_prolifera	Tectariaceae
Tectaria_barberi	Tectariaceae
Tectaria_macleanii	Tectariaceae
Tectaria_herpetocaulos	Tectariaceae
Tectaria_wightii	Tectariaceae
Tectaria_polymorpha	Tectariaceae
Tectaria_heterocarpa	Tectariaceae
Tectaria_phaeocaulis	Tectariaceae
Tectaria_gaudichaudii	Tectariaceae
Tectaria_zeylanica	Tectariaceae
Tectaria_variolosa	Tectariaceae
Tectaria_coadunata	Tectariaceae
Tectaria_paradoxa	Tectariaceae
Tectaria_gemmifera	Tectariaceae
Tectaria_fernandensis	Tectariaceae
Tectaria_labrusca	Tectariaceae
Tectaria_angulata	Tectariaceae
Tectaria_ferruginea	Tectariaceae
Tectaria_melanocaula	Tectariaceae
Tectaria_pica	Tectariaceae
Tectaria_vasta	Tectariaceae
Tectaria_fauriei	Tectariaceae
Tectaria_quinquefida	Tectariaceae
Tectaria_hekouensis	Tectariaceae
Tectaria_morsei	Tectariaceae
Tectaria_semipinnata	Tectariaceae
Tectaria_singaporiana	Tectariaceae
Tectaria_tricuspis	Tectariaceae
Gymnopteris_decurrens	Tectariaceae
Tectaria_repanda	Tectariaceae
Tectaria_harlandii	Tectariaceae
Tectaria_multicaudata	Tectariaceae
Tectaria_psomiocarpa	Tectariaceae
Tectaria_sagenioides	Tectariaceae
Heterogonium_pinnatum	Tectariaceae
Tectaria_aurita	Tectariaceae
Heterogonium_subglabrum	Tectariaceae
Tectaria_gigantea	Tectariaceae
Heterogonium_stenosemioides	Tectariaceae
Tectaria_fuscipes	Tectariaceae
Tectaria_setulosa	Tectariaceae
Tectaria_kusukusensis	Tectariaceae
Tectaria_subsageniacea	Tectariaceae
Tectaria_martinicensis	Tectariaceae
Tectaria_griffithii	Tectariaceae
Tectaria_yunnanensis	Tectariaceae
Pteridrys_australis	Pteridryaceae
Pteridrys_lofouensis	Pteridryaceae
Pteridrys_cnemidaria	Pteridryaceae
Pteridrys_syrmatica	Pteridryaceae
Pteridrys_microthecia	Pteridryaceae
Hypoderris_brauniana	Tectariaceae
Tectaria_nicotianifolia	Tectariaceae
Hypoderris_brownii	Tectariaceae
Triplophyllum_jenseniae	Tectariaceae
Triplophyllum_pentagonum	Tectariaceae
Triplophyllum_vogelii	Tectariaceae
Triplophyllum_fraternum	Tectariaceae
Triplophyllum_hirsutum	Tectariaceae
Triplophyllum_funestum	Tectariaceae
Triplophyllum_dicksonioides	Tectariaceae
Triplophyllum_crassifolium	Tectariaceae
Triplophyllum_glabrum	Tectariaceae
Triplophyllum_heudelotii	Tectariaceae
Arthropteris_altescandens	Tectariaceae
Arthropteris_tenella	Tectariaceae
Arthropteris_submarginalis	Tectariaceae
Arthropteris_palisotii	Tectariaceae
Arthropteris_beckleri	Tectariaceae
Arthropteris_repens	Tectariaceae
Arthropteris_guinanensis	Tectariaceae
Psammiosorus_paucivenius	Tectariaceae
Arthropteris_parallela	Tectariaceae
Arthropteris_monocarpa	Tectariaceae
Arthropteris_cameroonensis	Tectariaceae
Arthropteris_orientalis	Tectariaceae
Arthropteris_articulata	Tectariaceae
Davallodes_hymenophylloides	Davalliaceae
Wibelia_epiphylla	Davalliaceae
Wibelia_denticulata	Davalliaceae
Davallia_solida	Davalliaceae
Davallia_griffithiana	Davalliaceae
Davallia_tyermannii	Davalliaceae
Davallodes_yunnanensis	Davalliaceae
Davallia_mariesii	Davalliaceae
Davallia_repens	Davalliaceae
Humata_trifoliata	Davalliaceae
Araiostegiella_clarkei	Davalliaceae
Davallodes_hirsuta	Davalliaceae
Davallia_canariensis	Davalliaceae
Loxogramme_salicifolia	Polypodiaceae
Loxogramme_grammitoides	Polypodiaceae
Loxogramme_duclouxii	Polypodiaceae
Loxogramme_dictyopteris	Polypodiaceae
Loxogramme_avenia	Polypodiaceae
Loxogramme_abyssinica	Polypodiaceae
Loxogramme_lanceolata	Polypodiaceae
Loxogramme_mexicana	Polypodiaceae
Dictymia_mckeei	Polypodiaceae
Dictymia_brownii	Polypodiaceae
Polypodium_lepidotrichum	Polypodiaceae
Polypodium_myriolepis	Polypodiaceae
Polypodium_collinsii	Polypodiaceae
Polypodium_pyrrholepis	Polypodiaceae
Polypodium_sanctae_rosae	Thelypteridaceae
Polypodium_macrolepis	Polypodiaceae
Polypodium_hirsutissimum	Polypodiaceae
Polypodium_lepidopteris	Polypodiaceae
Pleopeltis_bombycina	Polypodiaceae
Polypodium_rosei	Polypodiaceae
Polypodium_friedrichsthalianum	Polypodiaceae
Pleopeltis_disjuncta	Polypodiaceae
Polypodium_furfuraceum	Polypodiaceae
Pseudocolysis_bradeorum	Polypodiaceae
Neurodium_lanceolatum	Polypodiaceae
Dicranoglossum_panamense	Polypodiaceae
Dicranoglossum_desvauxii	Polypodiaceae
Pleopeltis_angusta	Polypodiaceae
Pleopeltis_complanata	Polypodiaceae
Pleopeltis_ballivianii	Polypodiaceae
Pleopeltis_fraseri	Polypodiaceae
Pleopeltis_remota	Polypodiaceae
Pleopeltis_tweediana	Polypodiaceae
Pleopeltis_pleopeltifolia	Polypodiaceae
Pleopeltis_appressa	Polypodiaceae
Pleopeltis_polypodioides	Polypodiaceae
Polypodium_monosorum	Polypodiaceae
Polypodium_murorum	Polypodiaceae
Pleopeltis_pycnocarpa	Polypodiaceae
Pleopeltis_buchtienii	Polypodiaceae
Pleopeltis_munchii	Polypodiaceae
Polypodium_ensiforme	Polypodiaceae
Polypodium_madrense	Polypodiaceae
Pleopeltis_thyssanolepis	Polypodiaceae
Polypodium_platylepis	Polypodiaceae
Polypodium_rzedowskianum	Polypodiaceae
Polypodium_plebeium	Polypodiaceae
Polypodium_montigenum	Polypodiaceae
Pleopeltis_mexicana	Polypodiaceae
Pleopeltis_conzattii	Polypodiaceae
Pleopeltis_polylepis	Polypodiaceae
Pleopeltis_crassinervata	Polypodiaceae
Pleopeltis_macrocarpa	Polypodiaceae
Pleopeltis_wiesbaurii	Polypodiaceae
Pleopeltis_fructuosa	Polypodiaceae
Pleopeltis_fallax	Polypodiaceae
Pleopeltis_astrolepis	Polypodiaceae
Pleopeltis_intermedia	Polypodiaceae
Polypodium_guttatum	Polypodiaceae
Phlebodium_pseudoaureum	Polypodiaceae
Phlebodium_decumanum	Polypodiaceae
Phlebodium_areolatum	Polypodiaceae
Pecluma_eurybasis	Polypodiaceae
Pecluma_divaricata	Polypodiaceae
Pecluma_ptilodon	Polypodiaceae
Pecluma_pectinatiformis	Polypodiaceae
Pecluma_alfredii	Polypodiaceae
Polypodium_hartwegianum	Polypodiaceae
Polypodium_longepinnulatum	Polypodiaceae
Polypodium_rhachipterygium	Polypodiaceae
Polypodium_dulce	Polypodiaceae
Polypodium_chnoophorum	Polypodiaceae
Pleurosoriopsis_makinoi	Polypodiaceae
Polypodium_appalachianum	Polypodiaceae
Polypodium_sibiricum	Polypodiaceae
Polypodium_virginianum	Polypodiaceae
Polypodium_fauriei	Polypodiaceae
Polypodium_azoricum	Polypodiaceae
Polypodium_macaronesicum	Polypodiaceae
Polypodium_cambricum	Polypodiaceae
Polypodium_interjectum	Polypodiaceae
Polypodium_australe	Polypodiaceae
Polypodium_vulgare	Polypodiaceae
Polypodium_glycyrrhiza	Polypodiaceae
Polypodium_californicum	Polypodiaceae
Polypodium_pellucidum	Polypodiaceae
Polypodium_scouleri	Polypodiaceae
Polypodium_hesperium	Polypodiaceae
Polypodium_amorphum	Polypodiaceae
Polypodium_glaberulum	Polypodiaceae
Polypodium_echinolepis	Polypodiaceae
Polypodium_subpetiolatum	Polypodiaceae
Polypodium_adelphum	Polypodiaceae
Polypodium_fuscopetiolatum	Polypodiaceae
Polypodium_plesiosorum	Polypodiaceae
Polypodium_colpodes	Polypodiaceae
Polypodium_rhodopleuron	Polypodiaceae
Polypodium_arcanum	Polypodiaceae
Polypodium_martensii	Polypodiaceae
Campyloneurum_repens	Polypodiaceae
Campyloneurum_latum	Polypodiaceae
Campyloneurum_minus	Polypodiaceae
Campyloneurum_brevifolium	Polypodiaceae
Campyloneurum_phyllitidis	Polypodiaceae
Campyloneurum_xalapense	Polypodiaceae
Campyloneurum_wercklei	Polypodiaceae
Campyloneurum_anetioides	Polypodiaceae
Campyloneurum_aphanophlebium	Polypodiaceae
Campyloneurum_angustifolium	Polypodiaceae
Campyloneurum_chlorolepis	Polypodiaceae
Campyloneurum_asplundii	Polypodiaceae
Campyloneurum_magnificum	Polypodiaceae
Niphidium_nidulare	Polypodiaceae
Niphidium_crassifolium	Polypodiaceae
Niphidium_albopunctatissimum	Polypodiaceae
Niphidium_longifolium	Polypodiaceae
Microgramma_squamulosa	Polypodiaceae
Microgramma_bifrons	Polypodiaceae
Microgramma_brunei	Polypodiaceae
Microgramma_lycopodioides	Polypodiaceae
Microgramma_baldwinii	Polypodiaceae
Microgramma_nitida	Polypodiaceae
Microgramma_microsoroides	Polypodiaceae
Microgramma_megalophylla	Polypodiaceae
Microgramma_mauritiana	Polypodiaceae
Microgramma_vacciniifolia	Polypodiaceae
Microgramma_latevagans	Polypodiaceae
Microgramma_fuscopunctata	Polypodiaceae
Microgramma_tecta	Polypodiaceae
Microgramma_percussa	Polypodiaceae
Polypodium_chrysolepis	Polypodiaceae
Serpocaulon_attenuatum	Polypodiaceae
Serpocaulon_dissimile	Polypodiaceae
Serpocaulon_wagneri	Polypodiaceae
Serpocaulon_vacillans	Polypodiaceae
Serpocaulon_catharinae	Polypodiaceae
Serpocaulon_lasiopus	Polypodiaceae
Serpocaulon_crystalloneuron	Polypodiaceae
Serpocaulon_silvulae	Polypodiaceae
Serpocaulon_gilliesii	Polypodiaceae
Serpocaulon_richardii	Polypodiaceae
Serpocaulon_adnatum	Polypodiaceae
Serpocaulon_funckii	Polypodiaceae
Serpocaulon_ptilorhizon	Polypodiaceae
Serpocaulon_fraxinifolium	Polypodiaceae
Serpocaulon_dasypleuron	Polypodiaceae
Serpocaulon_latissimum	Polypodiaceae
Serpocaulon_latipes	Polypodiaceae
Serpocaulon_intricatum	Polypodiaceae
Serpocaulon_levigatum	Polypodiaceae
Polypodium_wiesbaueri	Polypodiaceae
Serpocaulon_patentissimum	Polypodiaceae
Serpocaulon_polystichum	Polypodiaceae
Serpocaulon_falcaria	Polypodiaceae
Serpocaulon_loriceum	Polypodiaceae
Serpocaulon_maritimum	Polypodiaceae
Serpocaulon_loriciforme	Polypodiaceae
Serpocaulon_appressum	Polypodiaceae
Serpocaulon_caceresii	Polypodiaceae
Serpocaulon_giganteum	Polypodiaceae
Serpocaulon_sessilifolium	Polypodiaceae
Serpocaulon_subandinum	Polypodiaceae
Serpocaulon_eleutherophlebium	Polypodiaceae
Serpocaulon_meniscifolium	Polypodiaceae
Serpocaulon_triseriale	Polypodiaceae
Terpsichore_hanekeana	Polypodiaceae
Terpsichore_eggersii	Polypodiaceae
Terpsichore_aspleniifolia	Polypodiaceae
Terpsichore_lehmanniana	Polypodiaceae
Terpsichore_chrysleri	Polypodiaceae
Grammitis_paramicola	Polypodiaceae
Grammitis_bryophila	Polypodiaceae
Grammitis_cryptophlebia	Polypodiaceae
Grammitis_melanoloma	Polypodiaceae
Grammitis_kyimbilensis	Polypodiaceae
Cochlidium_punctatum	Polypodiaceae
Cochlidium_serrulatum	Polypodiaceae
Cochlidium_seminudum	Polypodiaceae
Cochlidium_rostratum	Polypodiaceae
Grammitis_turquina	Polypodiaceae
Enterosora_sprucei	Polypodiaceae
Enterosora_parietina	Polypodiaceae
Adenophorus_periens	Polypodiaceae
Adenophorus_tamariscinus	Polypodiaceae
Adenophorus_epigaeus	Polypodiaceae
Adenophorus_montanus	Polypodiaceae
Adenophorus_abietinus	Polypodiaceae
Adenophorus_hymenophylloides	Polypodiaceae
Adenophorus_tripinnatifidus	Polypodiaceae
Adenophorus_oahuensis	Polypodiaceae
Adenophorus_haalilioanus	Polypodiaceae
Adenophorus_pinnatifidus	Polypodiaceae
Grammitis_tenella	Polypodiaceae
Notogrammitis_heterophylla	Polypodiaceae
Notogrammitis_ciliata	Polypodiaceae
Notogrammitis_rawlingsii	Polypodiaceae
Notogrammitis_pseudociliata	Polypodiaceae
Notogrammitis_billardierei	Polypodiaceae
Notogrammitis_givenii	Polypodiaceae
Notogrammitis_patagonica	Polypodiaceae
Notogrammitis_angustifolia	Polypodiaceae
Notogrammitis_crassior	Polypodiaceae
Notogrammitis_rigida	Polypodiaceae
Grammitis_pseudaustralis	Polypodiaceae
Grammitis_deplanchei	Polypodiaceae
Grammitis_nudicarpa	Polypodiaceae
Grammitis_diminuta	Polypodiaceae
Ctenopteris_lasiostipes	Polypodiaceae
Moranopteris_grisebachii	Polypodiaceae
Moranopteris_nana	Polypodiaceae
Moranopteris_setosa	Polypodiaceae
Moranopteris_perpusilla	Polypodiaceae
Moranopteris_achilleifolia	Polypodiaceae
Moranopteris_gradata	Polypodiaceae
Moranopteris_serricula	Polypodiaceae
Moranopteris_zurquina	Polypodiaceae
Moranopteris_trichomanoides	Polypodiaceae
Moranopteris_microlepis	Polypodiaceae
Moranopteris_plicata	Polypodiaceae
Moranopteris_williamsii	Polypodiaceae
Moranopteris_cookii	Polypodiaceae
Moranopteris_caucana	Polypodiaceae
Moranopteris_truncicola	Polypodiaceae
Moranopteris_taenifolia	Polypodiaceae
Moranopteris_blepharidea	Polypodiaceae
Moranopteris_hyalina	Polypodiaceae
Moranopteris_basiattenuata	Polypodiaceae
Moranopteris_aphelolepis	Polypodiaceae
Moranopteris_longisetosa	Polypodiaceae
Calymmodon_luerssenianus	Polypodiaceae
Calymmodon_mnioides	Polypodiaceae
Calymmodon_gracilis	Polypodiaceae
Calymmodon_clavifer	Polypodiaceae
Micropolypodium_sikkimense	Polypodiaceae
Xiphopterella_sparsipilosa	Polypodiaceae
Xiphopterella_hieronymusii	Polypodiaceae
Tomophyllum_repandulum	Polypodiaceae
Tomophyllum_macrum	Polypodiaceae
Tomophyllum_walleri	Polypodiaceae
Tomophyllum_secundum	Polypodiaceae
Tomophyllum_sakaguchianum	Polypodiaceae
Scleroglossum_wooroonooran	Polypodiaceae
Scleroglossum_pusillum	Polypodiaceae
Scleroglossum_sulcatum	Polypodiaceae
Dasygrammitis_crassifrons	Polypodiaceae
Dasygrammitis_fuscata	Polypodiaceae
Dasygrammitis_brevivenosa	Polypodiaceae
Dasygrammitis_mollicoma	Polypodiaceae
Dasygrammitis_malaccana	Polypodiaceae
Ctenopterella_denticulata	Polypodiaceae
Acrosorus_friderici_et_pauli	Polypodiaceae
Chrysogrammitis_musgraveana	Polypodiaceae
Chrysogrammitis_glandulosa	Polypodiaceae
Ctenopterella_parvula	Polypodiaceae
Grammitis_stenophylla	Polypodiaceae
Grammitis_obtusa	Polypodiaceae
Micropolypodium_okuboi	Polypodiaceae
Prosaptia_celebica	Polypodiaceae
Prosaptia_alata	Polypodiaceae
Prosaptia_contigua	Polypodiaceae
Calymmodon_curtus	Polypodiaceae
Prosaptia_pubipes	Polypodiaceae
Prosaptia_palauensis	Polypodiaceae
Prosaptia_rhodocarpa	Polypodiaceae
Ctenopteris_kanashiroi	Polypodiaceae
Prosaptia_obliquata	Polypodiaceae
Ctenopteris_curtisii	Polypodiaceae
Prosaptia_maidenii	Polypodiaceae
Prosaptia_davalliacea	Polypodiaceae
Grammitis_wattsii	Polypodiaceae
Prosaptia_venulosa	Polypodiaceae
Prosaptia_nutans	Polypodiaceae
Radiogrammitis_hirtella	Polypodiaceae
Radiogrammitis_kinabaluensis	Polypodiaceae
Oreogrammitis_adspersa	Polypodiaceae
Radiogrammitis_cheesemanii	Polypodiaceae
Radiogrammitis_holttumii	Polypodiaceae
Oreogrammitis_uapensis	Polypodiaceae
Oreogrammitis_wurunuran	Polypodiaceae
Grammitis_dolichosora	Polypodiaceae
Oreogrammitis_reinwardtioides	Polypodiaceae
Oreogrammitis_congener	Polypodiaceae
Oreogrammitis_locellata	Polypodiaceae
Grammitis_lasiosora	Polypodiaceae
Themelium_halconense	Polypodiaceae
Themelium_tenuisectum	Polypodiaceae
Themelium_decrescens	Polypodiaceae
Themelium_conjunctisorum	Polypodiaceae
Radiogrammitis_hirtelloides	Polypodiaceae
Grammitis_baldwinii	Polypodiaceae
Grammitis_forbesiana	Polypodiaceae
Grammitis_hookeri	Polypodiaceae
Grammitis_knutsfordiana	Polypodiaceae
Grammitis_tuyamae	Polypodiaceae
Radiogrammitis_setigera	Polypodiaceae
Grammitis_reinwardtii	Polypodiaceae
Radiogrammitis_havilandii	Polypodiaceae
Radiogrammitis_jagoriana	Polypodiaceae
Grammitis_dorsipila	Polypodiaceae
Grammitis_padangensis	Polypodiaceae
Radiogrammitis_parva	Polypodiaceae
Mycopteris_taxifolia	Polypodiaceae
Mycopteris_amphidasyon	Polypodiaceae
Mycopteris_longipilosa	Polypodiaceae
Mycopteris_zeledoniana	Polypodiaceae
Mycopteris_praeceps	Polypodiaceae
Mycopteris_longicaulis	Polypodiaceae
Mycopteris_leucosticta	Polypodiaceae
Mycopteris_attenuatissima	Polypodiaceae
Mycopteris_alsopteris	Polypodiaceae
Mycopteris_semihirsuta	Polypodiaceae
Mycopteris_subtilis	Polypodiaceae
Mycopteris_cretata	Polypodiaceae
Stenogrammitis_wittigiana	Polypodiaceae
Stenogrammitis_myosuroides	Polypodiaceae
Stenogrammitis_oosora	Polypodiaceae
Stenogrammitis_saffordii	Polypodiaceae
Stenogrammitis_hellwigii	Polypodiaceae
Stenogrammitis_subcoriacea	Polypodiaceae
Lellingeria_hartii	Polypodiaceae
Stenogrammitis_prionodes	Polypodiaceae
Stenogrammitis_pumila	Polypodiaceae
Stenogrammitis_limula	Polypodiaceae
Stenogrammitis_hildebrandtii	Polypodiaceae
Lellingeria_hirsuta	Polypodiaceae
Lellingeria_subimpressa	Polypodiaceae
Lellingeria_suprasculpta	Polypodiaceae
Lellingeria_dissimulans	Polypodiaceae
Lellingeria_depressa	Polypodiaceae
Lellingeria_suspensa	Polypodiaceae
Lellingeria_phlegmaria	Polypodiaceae
Lellingeria_tenuicula	Polypodiaceae
Polypodium_kaieteurum	Polypodiaceae
Lellingeria_isidrensis	Polypodiaceae
Lellingeria_simacensis	Polypodiaceae
Lellingeria_melanotrichia	Polypodiaceae
Lellingeria_randallii	Polypodiaceae
Lellingeria_brevistipes	Polypodiaceae
Lellingeria_pseudocapillaris	Polypodiaceae
Lellingeria_pendula	Polypodiaceae
Lellingeria_flagellipinnata	Polypodiaceae
Lellingeria_subsessilis	Polypodiaceae
Lellingeria_bishopii	Polypodiaceae
Lellingeria_itatimensis	Polypodiaceae
Lellingeria_ciliolepis	Polypodiaceae
Lellingeria_jimenezii	Polypodiaceae
Lellingeria_oreophila	Polypodiaceae
Lellingeria_calolepis	Polypodiaceae
Lellingeria_paramicola	Polypodiaceae
Lellingeria_major	Polypodiaceae
Lellingeria_humilis	Polypodiaceae
Lellingeria_tamandarei	Polypodiaceae
Lellingeria_apiculata	Polypodiaceae
Lellingeria_affinis	Polypodiaceae
Melpomene_gracilis	Polypodiaceae
Melpomene_allosuroides	Polypodiaceae
Melpomene_firma	Polypodiaceae
Melpomene_occidentalis	Polypodiaceae
Melpomene_melanosticta	Polypodiaceae
Melpomene_pseudonutans	Polypodiaceae
Melpomene_vulcanica	Polypodiaceae
Melpomene_wolfii	Polypodiaceae
Melpomene_sklenarii	Polypodiaceae
Melpomene_flabelliformis	Polypodiaceae
Melpomene_caput_gorgonis	Polypodiaceae
Melpomene_paradoxa	Polypodiaceae
Melpomene_albicans	Polypodiaceae
Melpomene_moniliformis	Polypodiaceae
Melpomene_sodiroi	Polypodiaceae
Melpomene_vernicosa	Polypodiaceae
Melpomene_xiphopteridoides	Polypodiaceae
Melpomene_erecta	Polypodiaceae
Melpomene_personata	Polypodiaceae
Melpomene_pilosissima	Polypodiaceae
Melpomene_anazalea	Polypodiaceae
Melpomene_peruviana	Polypodiaceae
Ctenopteris_rigescens	Polypodiaceae
Melpomene_leptostoma	Polypodiaceae
Galactodenia_parrisiae	Polypodiaceae
Galactodenia_delicatula	Polypodiaceae
Galactodenia_subscabra	Polypodiaceae
Ascogrammitis_nana	Polypodiaceae
Ascogrammitis_anfractuosa	Polypodiaceae
Ascogrammitis_athyrioides	Polypodiaceae
Ascogrammitis_clavigera	Polypodiaceae
Ascogrammitis_colombiensis	Polypodiaceae
Ascogrammitis_pichinchae	Polypodiaceae
Ascogrammitis_loxensis	Polypodiaceae
Ascogrammitis_angustipes	Polypodiaceae
Ascogrammitis_dilatata	Polypodiaceae
Ascogrammitis_cuencana	Polypodiaceae
Ascogrammitis_clathrata	Polypodiaceae
Ascogrammitis_david_smithii	Polypodiaceae
Ascogrammitis_pichinchensis	Polypodiaceae
Zygophlebia_devoluta	Polypodiaceae
Zygophlebia_torulosa	Polypodiaceae
Enterosora_entersoroides	Polypodiaceae
Enterosora_trifurcata	Polypodiaceae
Enterosora_trichosora	Polypodiaceae
Enterosora_percrassa	Polypodiaceae
Zygophlebia_sectifrons	Polypodiaceae
Zygophlebia_mathewsii	Polypodiaceae
Ceradenia_leucosora	Polypodiaceae
Ceradenia_argyrata	Polypodiaceae
Enterosora_barbatula	Polypodiaceae
Ceradenia_spixiana	Polypodiaceae
Ceradenia_aulaeifolia	Polypodiaceae
Ceradenia_intricata	Polypodiaceae
Ceradenia_intonsa	Polypodiaceae
Ceradenia_madidiense	Polypodiaceae
Ceradenia_ayapoyana	Polypodiaceae
Ceradenia_kalbreyeri	Polypodiaceae
Ceradenia_fucoides	Polypodiaceae
Ceradenia_pearcei	Polypodiaceae
Ceradenia_curvata	Polypodiaceae
Ceradenia_farinosa	Polypodiaceae
Ceradenia_pilipes	Polypodiaceae
Ceradenia_jungermannioides	Polypodiaceae
Alansmia_glandulifera	Polypodiaceae
Terpsichore_mollissima	Polypodiaceae
Alansmia_elastica	Polypodiaceae
Alansmia_senilis	Polypodiaceae
Alansmia_cultrata	Polypodiaceae
Alansmia_smithii	Polypodiaceae
Alansmia_lanigera	Polypodiaceae
Alansmia_stella	Polypodiaceae
Alansmia_heterophylla	Polypodiaceae
Leucotrichum_mitchellae	Polypodiaceae
Lellingeria_pseudomitchellae	Polypodiaceae
Leucotrichum_organense	Polypodiaceae
Leucotrichum_mortonii	Polypodiaceae
Leucotrichum_schenckii	Polypodiaceae
Leucotrichum_madagascariense	Polypodiaceae
Drynaria_rigidula	Polypodiaceae
Drynaria_sparsisora	Polypodiaceae
Drynaria_descensa	Polypodiaceae
Drynaria_quercifolia	Polypodiaceae
Drynaria_bonii	Polypodiaceae
Drynaria_sinica	Polypodiaceae
Aglaomorpha_coronans	Polypodiaceae
Aglaomorpha_pilosa	Polypodiaceae
Aglaomorpha_hieronymi	Polypodiaceae
Aglaomorpha_parkinsonii	Polypodiaceae
Aglaomorpha_acuminata	Polypodiaceae
Photinopteris_speciosa	Polypodiaceae
Aglaomorpha_splendens	Polypodiaceae
Aglaomorpha_novoguineensis	Polypodiaceae
Aglaomorpha_latipinna	Polypodiaceae
Aglaomorpha_drynarioides	Polypodiaceae
Aglaomorpha_heraclea	Polypodiaceae
Aglaomorpha_meyeniana	Polypodiaceae
Drynaria_mollis	Polypodiaceae
Drynaria_fortunei	Polypodiaceae
Drynaria_roosii	Polypodiaceae
Christiopteris_sagitta	Polypodiaceae
Christiopteris_tricuspis	Polypodiaceae
Drynaria_willdenowii	Polypodiaceae
Drynaria_laurentii	Polypodiaceae
Drynaria_volkensii	Polypodiaceae
Selliguea_veitchii	Polypodiaceae
Phymatopteris_crenatopinnata	Polypodiaceae
Phymatopteris_conjuncta	Polypodiaceae
Phymatopteris_malacodon	Polypodiaceae
Phymatopteris_tibetana	Polypodiaceae
Phymatopteris_stewartii	Polypodiaceae
Phymatopteris_stracheyi	Polypodiaceae
Phymatopteris_conmixta	Polypodiaceae
Gymnogrammitis_dareiformis	Polypodiaceae
Phymatopteris_oxyloba	Polypodiaceae
Phymatopteris_suboxyloba	Polypodiaceae
Phymatopteris_trisecta	Polypodiaceae
Arthromeris_tatsienensis	Polypodiaceae
Arthromeris_wallichiana	Polypodiaceae
Arthromeris_cyrtomioides	Polypodiaceae
Arthromeris_lehmannii	Polypodiaceae
Arthromeris_mairei	Polypodiaceae
Arthromeris_himalayensis	Polypodiaceae
Selliguea_laciniata	Polypodiaceae
Selliguea_feei	Polypodiaceae
Selliguea_feeoides	Polypodiaceae
Selliguea_plantaginea	Polypodiaceae
Selliguea_lanceolata	Polypodiaceae
Selliguea_lanceola	Polypodiaceae
Selliguea_triloba	Polypodiaceae
Polypodiopteris_brachypoda	Polypodiaceae
Selliguea_enervis	Polypodiaceae
Selliguea_subsparsa	Polypodiaceae
Selliguea_hellwigii	Polypodiaceae
Selliguea_heterocarpa	Polypodiaceae
Selliguea_lateritia	Polypodiaceae
Phymatopteris_pianmaensis	Polypodiaceae
Phymatopteris_albopes	Polypodiaceae
Selliguea_yakuinsularis	Polypodiaceae
Phymatopteris_integerrima	Polypodiaceae
Phymatopteris_majoensis	Polypodiaceae
Phymatopteris_griffithiana	Polypodiaceae
Phymatopteris_simplicifolia	Polypodiaceae
Phymatopteris_hastata	Polypodiaceae
Selliguea_yakushimensis	Polypodiaceae
Selliguea_engleri	Polypodiaceae
Phymatopteris_chrysotricha	Polypodiaceae
Phymatopteris_dactylina	Polypodiaceae
Phymatopteris_rhynchophylla	Polypodiaceae
Phymatopteris_subebenipes	Polypodiaceae
Phymatopteris_ebenipes	Polypodiaceae
Synammia_intermedia	Polypodiaceae
Synammia_feuillei	Polypodiaceae
Pyrrosia_liebuschii	Polypodiaceae
Platycerium_andinum	Polypodiaceae
Platycerium_alcicorne	Polypodiaceae
Platycerium_madagascariense	Polypodiaceae
Platycerium_quadridichotomum	Polypodiaceae
Platycerium_ellisii	Polypodiaceae
Platycerium_elephantotis	Polypodiaceae
Platycerium_holttumii	Polypodiaceae
Platycerium_superbum	Polypodiaceae
Platycerium_stemaria	Polypodiaceae
Platycerium_wandae	Polypodiaceae
Platycerium_wallichii	Polypodiaceae
Platycerium_grande	Polypodiaceae
Platycerium_ridleyi	Polypodiaceae
Platycerium_coronarium	Polypodiaceae
Platycerium_veitchii	Polypodiaceae
Platycerium_hillii	Polypodiaceae
Platycerium_willinckii	Polypodiaceae
Platycerium_bifurcatum	Polypodiaceae
Pyrrosia_stigmosa	Polypodiaceae
Pyrrosia_niphoboloides	Polypodiaceae
Pyrrosia_nummulariifolia	Polypodiaceae
Pyrrosia_samarensis	Polypodiaceae
Pyrrosia_angustata	Polypodiaceae
Pyrrosia_lingua	Polypodiaceae
Pyrrosia_christii	Polypodiaceae
Pyrrosia_hastata	Polypodiaceae
Pyrrosia_polydactyla	Polypodiaceae
Pyrrosia_flocculosa	Polypodiaceae
Pyrrosia_assimilis	Polypodiaceae
Pyrrosia_porosa	Polypodiaceae
Pyrrosia_mannii	Polypodiaceae
Pyrrosia_davidii	Polypodiaceae
Pyrrosia_linearifolia	Polypodiaceae
Pyrrosia_subfurfuracea	Polypodiaceae
Pyrrosia_piloselloides	Polypodiaceae
Pyrrosia_nuda	Polypodiaceae
Pyrrosia_adnascens	Polypodiaceae
Pyrrosia_rasamalae	Polypodiaceae
Pyrrosia_lanceolata	Polypodiaceae
Pyrrosia_eleagnifolia	Polypodiaceae
Pyrrosia_rupestris	Polypodiaceae
Pyrrosia_longifolia	Polypodiaceae
Pyrrosia_foveolata	Polypodiaceae
Pyrrosia_serpens	Polypodiaceae
Thylacopteris_papillosa	Polypodiaceae
Microsorum_rubidum	Polypodiaceae
Microsorum_membranifolium	Polypodiaceae
Phymatosorus_lucidus	Polypodiaceae
Phymatosorus_cuspidatus	Polypodiaceae
Phymatosorus_hainanensis	Polypodiaceae
Microsorum_spectrum	Polypodiaceae
Colysis_pentaphylla	Polypodiaceae
Colysis_longipes	Polypodiaceae
Colysis_elegans	Polypodiaceae
Leptochilus_cantoniensis	Polypodiaceae
Paraleptochilus_decurrens	Polypodiaceae
Leptochilus_axillaris	Polypodiaceae
Colysis_hemionitidea	Polypodiaceae
Colysis_leveillei	Polypodiaceae
Colysis_henryi	Polypodiaceae
Colysis_simplicifrons	Polypodiaceae
Colysis_elliptica	Polypodiaceae
Colysis_pothifolia	Polypodiaceae
Colysis_triphylla	Polypodiaceae
Colysis_wrightii	Polypodiaceae
Colysis_digitata	Polypodiaceae
Colysis_flexiloba	Polypodiaceae
Colysis_hemitoma	Polypodiaceae
Kontumia_heterophylla	Polypodiaceae
Colysis_pteropus	Polypodiaceae
Colysis_intermedia	Polypodiaceae
Microsorum_dilatatum	Polypodiaceae
Colysis_insignis	Polypodiaceae
Microsorum_commutatum	Polypodiaceae
Microsorum_thailandicum	Polypodiaceae
Microsorum_whiteheadii	Polypodiaceae
Microsorum_musifolium	Polypodiaceae
Microsorum_punctatum	Polypodiaceae
Polypodium_polycarpon	Polypodiaceae
Microsorum_scolopendria	Polypodiaceae
Microsorum_grossum	Polypodiaceae
Microsorum_papuanum	Polypodiaceae
Lepisorus_longifolius	Polypodiaceae
Polypodium_maculosum	Polypodiaceae
Neocheiropteris_palmatopedata	Polypodiaceae
Neocheiropteris_triglossa	Polypodiaceae
Lepidomicrosorium_buergerianum	Polypodiaceae
Lepidomicrosorium_subhemionitideum	Polypodiaceae
Neocheiropteris_subhastata	Polypodiaceae
Tricholepidium_normale	Polypodiaceae
Lepidomicrosorium_superficiale	Polypodiaceae
Colysis_shintenensis	Polypodiaceae
Neolepisorus_zippelii	Polypodiaceae
Neolepisorus_fortunei	Polypodiaceae
Neolepisorus_pappei	Polypodiaceae
Neocheiropteris_ovata	Polypodiaceae
Neocheiropteris_phyllomanes	Polypodiaceae
Neocheiropteris_ensata	Polypodiaceae
Lemmaphyllum_accedens	Polypodiaceae
Lemmaphyllum_pyriforme	Polypodiaceae
Lemmaphyllum_carnosum	Polypodiaceae
Lemmaphyllum_diversum	Polypodiaceae
Lepidogrammitis_drymoglossoides	Polypodiaceae
Lemmaphyllum_intermedium	Polypodiaceae
Lepidogrammitis_adnascens	Polypodiaceae
Lemmaphyllum_microphyllum	Polypodiaceae
Lepidogrammitis_rostrata	Polypodiaceae
Lemmaphyllum_squamatum	Polypodiaceae
Lepisorus_megasorus	Polypodiaceae
Lepisorus_kawakamii	Polypodiaceae
Lepisorus_kuchenensis	Polypodiaceae
Lepisorus_affinis	Polypodiaceae
Lepisorus_subsessilis	Polypodiaceae
Lepisorus_macrosphaerus	Polypodiaceae
Lepisorus_nudus	Polypodiaceae
Lepisorus_marginatus	Polypodiaceae
Lepisorus_asterolepis	Polypodiaceae
Lepisorus_morrisonensis	Polypodiaceae
Lepisorus_bicolor	Polypodiaceae
Lepisorus_excavatus	Polypodiaceae
Lepisorus_rotundus	Polypodiaceae
Lepisorus_schraderi	Polypodiaceae
Lepisorus_perrierianus	Polypodiaceae
Lepisorus_vesiculari_paleaceus	Polypodiaceae
Lepisorus_bampsii	Polypodiaceae
Lepisorus_scolopendrius	Polypodiaceae
Lepisorus_hsiaowutaiensis	Polypodiaceae
Lepisorus_patungensis	Polypodiaceae
Lepisorus_albertii	Polypodiaceae
Lepisorus_pumilus	Polypodiaceae
Lepisorus_thaipaiensis	Polypodiaceae
Lepisorus_clathratus	Polypodiaceae
Platygyria_waltonii	Polypodiaceae
Platygyria_soulieana	Polypodiaceae
Lepisorus_likiangensis	Polypodiaceae
Lepisorus_spicatus	Polypodiaceae
Lepisorus_platyrhynchos	Polypodiaceae
Lepisorus_mucronatus	Polypodiaceae
Lepisorus_henryi	Polypodiaceae
Lepisorus_annamensis	Polypodiaceae
Lepisorus_onoei	Polypodiaceae
Lepisorus_hachijoensis	Polypodiaceae
Lepisorus_monilisorus	Polypodiaceae
Lepisorus_boninensis	Polypodiaceae
Lepisorus_miyoshianus	Polypodiaceae
Lepisorus_sublinearis	Polypodiaceae
Lepisorus_loriformis	Polypodiaceae
Lepisorus_xiphiopteris	Polypodiaceae
Lepisorus_pseudonudus	Polypodiaceae
Lepisorus_stenistus	Polypodiaceae
Lepisorus_lineariformis	Polypodiaceae
Lepisorus_elegans	Polypodiaceae
Lepisorus_contortus	Polypodiaceae
Lepisorus_sinensis	Polypodiaceae
Lepisorus_medogensis	Polypodiaceae
Lepisorus_sordidus	Polypodiaceae
Lepisorus_confluens	Polypodiaceae
Lepisorus_nyalamensis	Polypodiaceae
Lepisorus_angustatus	Polypodiaceae
Lepisorus_obscurevenolusus	Polypodiaceae
Lepisorus_subconfluens	Polypodiaceae
Lepisorus_suboligolepidus	Polypodiaceae
Lepisorus_luchunensis	Polypodiaceae
Lepisorus_lewisii	Polypodiaceae
Lepisorus_angustus	Polypodiaceae
Lepisorus_tibeticus	Polypodiaceae
Lepisorus_heterolepis	Polypodiaceae
Lepisorus_tosaensis	Polypodiaceae
Lepisorus_oligolepidus	Polypodiaceae
Lepisorus_thunbergianus	Polypodiaceae
Lepisorus_uchiyamae	Polypodiaceae
Lepisorus_annuifrons	Polypodiaceae
Lepisorus_pseudoussuriensis	Polypodiaceae
Lepisorus_ussuriensis	Polypodiaceae
Microsorum_membranaceum	Polypodiaceae
Lecanopteris_mirabilis	Polypodiaceae
Lecanopteris_lomarioides	Polypodiaceae
Lecanopteris_sarcopus	Polypodiaceae
Lecanopteris_crustacea	Polypodiaceae
Lecanopteris_carnosa	Polypodiaceae
Lecanopteris_spinosa	Polypodiaceae
Lecanopteris_deparioides	Polypodiaceae
Lecanopteris_celebica	Polypodiaceae
Lecanopteris_balgooyi	Polypodiaceae
Lecanopteris_luzonensis	Polypodiaceae
Lecanopteris_pumila	Polypodiaceae
Lecanopteris_sinuosa	Polypodiaceae
Microsorum_vieillardii	Polypodiaceae
Microsorum_pustulatum	Polypodiaceae
Microsorum_novae_zealandiae	Polypodiaceae
Colysis_ampla	Polypodiaceae
Microsorum_scandens	Polypodiaceae
Microsorum_varians	Polypodiaceae
Microsorum_linguiforme	Polypodiaceae
Microsorum_lastii	Polypodiaceae
Goniophlebium_subauriculatum	Polypodiaceae
Goniophlebium_pseudoconnatum	Polypodiaceae
Goniophlebium_mehibitense	Polypodiaceae
Goniophlebium_percussum	Polypodiaceae
Goniophlebium_persicifolium	Polypodiaceae
Polypodiodes_microrhizoma	Polypodiaceae
Metapolypodium_manmeiense	Polypodiaceae
Goniophlebium_argutum	Polypodiaceae
Goniophlebium_mengtzeense	Polypodiaceae
Goniophlebium_formosanum	Polypodiaceae
Polypodiodes_wattii	Polypodiaceae
Polypodium_niponicum	Polypodiaceae
Polypodium_amamianum	Polypodiaceae
Goniophlebium_amoenum	Polypodiaceae
Polypodiodes_chinensis	Polypodiaceae
Polypodiodes_subamoena	Polypodiaceae
Oleandra_pistillaris	Oleandraceae
Oleandra_neriiformis	Oleandraceae
Oleandra_cumingii	Oleandraceae
Oleandra_hainanensis	Oleandraceae
Nephrolepis_auriculata	Nephrolepidaceae
Nephrolepis_lauterbachii	Nephrolepidaceae
Nephrolepis_exaltata	Nephrolepidaceae
Nephrolepis_cordifolia	Nephrolepidaceae
Nephrolepis_multiflora	Nephrolepidaceae
Nephrolepis_undulata	Nephrolepidaceae
Nephrolepis_davalliae	Nephrolepidaceae
Nephrolepis_davallioides	Nephrolepidaceae
Nephrolepis_acutifolia	Nephrolepidaceae
Nephrolepis_acuminata	Nephrolepidaceae
Nephrolepis_brownii	Nephrolepidaceae
Nephrolepis_falciformis	Nephrolepidaceae
Nephrolepis_hirsutula	Nephrolepidaceae
Nephrolepis_obliterata	Nephrolepidaceae
Nephrolepis_biserrata	Nephrolepidaceae
Nephrolepis_radicans	Nephrolepidaceae
Nephrolepis_falcata	Nephrolepidaceae
Nephrolepis_abrupta	Nephrolepidaceae
Nephrolepis_pendula	Nephrolepidaceae
Nephrolepis_pectinata	Nephrolepidaceae
Nephrolepis_rivularis	Nephrolepidaceae
Dracoglossum_plantagineum	Lomariopsidaceae
Lomariopsis_spectabilis	Lomariopsidaceae
Lomariopsis_madagascarica	Lomariopsidaceae
Lomariopsis_boivinii	Lomariopsidaceae
Lomariopsis_crassifolia	Lomariopsidaceae
Lomariopsis_pervillei	Lomariopsidaceae
Lomariopsis_muriculata	Lomariopsidaceae
Lomariopsis_mannii	Lomariopsidaceae
Lomariopsis_hederacea	Lomariopsidaceae
Lomariopsis_rossii	Lomariopsidaceae
Lomariopsis_lineata	Lomariopsidaceae
Lomariopsis_pollicina	Lomariopsidaceae
Lomariopsis_cordata	Lomariopsidaceae
Lomariopsis_sorbifolia	Lomariopsidaceae
Lomariopsis_marginata	Lomariopsidaceae
Lomariopsis_japurensis	Lomariopsidaceae
Lomariopsis_latipinna	Lomariopsidaceae
Lomariopsis_palustris	Lomariopsidaceae
Lomariopsis_nigropaleata	Lomariopsidaceae
Lomariopsis_guineensis	Lomariopsidaceae
Lomariopsis_prieuriana	Lomariopsidaceae
Lomariopsis_salicifolia	Lomariopsidaceae
Lomariopsis_vestita	Lomariopsidaceae
Lomariopsis_recurvata	Lomariopsidaceae
Lomariopsis_maxonii	Lomariopsidaceae
Lomariopsis_amydrophlebia	Lomariopsidaceae
Lomariopsis_wrightii	Lomariopsidaceae
Lomariopsis_jamaicensis	Lomariopsidaceae
Lomariopsis_kunzeana	Lomariopsidaceae
Lomariopsis_longicaudata	Lomariopsidaceae
Cyclopeltis_crenata	Lomariopsidaceae
Cyclopeltis_semicordata	Lomariopsidaceae
Hypodematium_fordii	Hypodematiaceae
Hypodematium_glandulosopilosum	Hypodematiaceae
Hypodematium_crenatum	Hypodematiaceae
Leucostegia_pallida	Hypodematiaceae
Leucostegia_immersa	Hypodematiaceae
Didymochlaena_truncatula	Didymochlaenaceae
Hemidictyum_marginatum	Hemidictyaceae
Diplaziopsis_cavaleriana	Diplaziopsidaceae
Diplaziopsis_brunoniana	Diplaziopsidaceae
Homalosorus_pycnocarpos	Diplaziopsidaceae
Diplaziopsis_javanica	Diplaziopsidaceae
Gymnocarpium_oyamense	Cystopteridaceae
Gymnocarpium_dryopteris	Cystopteridaceae
Gymnocarpium_disjunctum	Cystopteridaceae
Gymnocarpium_remotepinnatum	Cystopteridaceae
Gymnocarpium_appalachianum	Cystopteridaceae
Gymnocarpium_robertianum	Cystopteridaceae
Gymnocarpium_jessoense	Cystopteridaceae
Cystopteris_montana	Cystopteridaceae
Cystopteris_kansuana	Cystopteridaceae
Cystopteris_moupinensis	Cystopteridaceae
Cystopteris_sudetica	Cystopteridaceae
Cystopteris_protrusa	Cystopteridaceae
Cystopteris_tasmanica	Cystopteridaceae
Cystopteris_fragilis	Cystopteridaceae
Cystopteris_alpina	Cystopteridaceae
Cystopteris_douglasii	Cystopteridaceae
Cystopteris_tenuis	Cystopteridaceae
Cystopteris_laurentiana	Cystopteridaceae
Cystopteris_millefolia	Cystopteridaceae
Cystopteris_diaphana	Cystopteridaceae
Cystopteris_membranifolia	Cystopteridaceae
Cystopteris_reevesiana	Cystopteridaceae
Cystopteris_sandwicensis	Cystopteridaceae
Cystoathyrium_chinense	Cystopteridaceae
Cystopteris_tennesseensis	Cystopteridaceae
Cystopteris_bulbifera	Cystopteridaceae
Cystopteris_utahensis	Cystopteridaceae
Cystopteris_pellucida	Cystopteridaceae
Acystopteris_tenuisecta	Cystopteridaceae
Acystopteris_japonica	Cystopteridaceae
Acystopteris_taiwaniana	Cystopteridaceae
Diplazium_cristatum	Athyriaceae
Diplazium_lonchophyllum	Athyriaceae
Diplazium_unilobum	Athyriaceae
Diplazium_bombonasae	Athyriaceae
Diplazium_plantaginifolium	Athyriaceae
Diplazium_pinfaense	Athyriaceae
Diplazium_longifolium	Athyriaceae
Diplazium_heterocarpum	Athyriaceae
Diplazium_okudairai	Athyriaceae
Diplazium_wichurae	Athyriaceae
Diplazium_squamigerum	Athyriaceae
Diplazium_lobbianum	Athyriaceae
Diplazium_australe	Athyriaceae
Diplazium_kawakamii	Athyriaceae
Diplazium_acanthopus	Athyriaceae
Diplazium_subspectabile	Athyriaceae
Diplazium_spectabile	Athyriaceae
Diplazium_latifrons	Athyriaceae
Diplazium_muricatum	Athyriaceae
Diplazium_pullingeri	Athyriaceae
Diplazium_crassiusculum	Athyriaceae
Diplazium_petrii	Athyriaceae
Diplazium_griffithii	Athyriaceae
Diplazium_mettenianum	Athyriaceae
Diplazium_fauriei	Athyriaceae
Diplazium_deciduum	Athyriaceae
Diplazium_yaoshanense	Athyriaceae
Diplazium_hirtipes	Athyriaceae
Diplazium_stoliczkae	Athyriaceae
Diplazium_tomentosum	Athyriaceae
Diplazium_sorzogonense	Athyriaceae
Diplazium_nemorale	Athyriaceae
Diplazium_pseudocyatheifolium	Athyriaceae
Diplazium_cordifolium	Athyriaceae
Diplazium_fraxinifolium	Athyriaceae
Diplazium_vestitum	Athyriaceae
Diplazium_lomariaceum	Athyriaceae
Diplazium_malaccense	Athyriaceae
Diplazium_subserratum	Athyriaceae
Diplazium_longicarpum	Athyriaceae
Diplazium_sylvaticum	Athyriaceae
Diplazium_incomptum	Athyriaceae
Diplazium_viridescens	Athyriaceae
Diplazium_pallidum	Athyriaceae
Diplazium_squamuligerum	Athyriaceae
Diplazium_proliferum	Athyriaceae
Diplazium_simplicivenium	Athyriaceae
Diplazium_spinulosum	Athyriaceae
Diplazium_echinatum	Athyriaceae
Diplazium_accedens	Athyriaceae
Diplazium_asperum	Athyriaceae
Diplazium_stenochlamys	Athyriaceae
Diplazium_simile	Athyriaceae
Diplazium_maximum	Athyriaceae
Diplazium_zanzibaricum	Athyriaceae
Diplazium_himalayense	Athyriaceae
Diplazium_viridissimum	Athyriaceae
Diplazium_giganteum	Athyriaceae
Diplazium_nipponicum	Athyriaceae
Diplazium_esculentum	Athyriaceae
Diplazium_multicaudatum	Athyriaceae
Diplazium_alatum	Athyriaceae
Diplazium_chinense	Athyriaceae
Diplazium_prolixum	Athyriaceae
Diplazium_subtripinnatum	Athyriaceae
Diplazium_petelotii	Athyriaceae
Diplazium_matthewii	Athyriaceae
Diplazium_pinnatifido_pinnatum	Athyriaceae
Diplazium_splendens	Athyriaceae
Diplazium_davaoense	Athyriaceae
Diplazium_hayatamae	Athyriaceae
Diplazium_dilatatum	Athyriaceae
Diplazium_megaphyllum	Athyriaceae
Diplazium_virescens	Athyriaceae
Diplazium_taiwanense	Athyriaceae
Diplazium_doederleinii	Athyriaceae
Diplazium_lobatum	Athyriaceae
Diplazium_hainanense	Athyriaceae
Diplazium_bantamense	Athyriaceae
Diplazium_donianum	Athyriaceae
Diplazium_nanchuanicum	Athyriaceae
Diplazium_hachijoense	Athyriaceae
Diplazium_amamianum	Athyriaceae
Diplazium_laxifrons	Athyriaceae
Diplazium_arborescens	Athyriaceae
Diplazium_divergens	Athyriaceae
Diplazium_bicolor	Athyriaceae
Diplazium_lindbergii	Athyriaceae
Diplazium_diplazioides	Athyriaceae
Diplazium_remotum	Athyriaceae
Diplazium_macrophyllum	Athyriaceae
Diplazium_balliviani	Athyriaceae
Diplazium_striatum	Athyriaceae
Diplazium_hians	Athyriaceae
Diplazium_legalloi	Athyriaceae
Diplazium_cuneifolium	Athyriaceae
Diplazium_pinnatifidum	Athyriaceae
Diplazium_centripetale	Athyriaceae
Diplazium_assimile	Athyriaceae
Diplazium_leptophyllum	Athyriaceae
Diplazium_ovatum	Athyriaceae
Diplazium_bellum	Athyriaceae
Diplazium_caudatum	Athyriaceae
Athyrium_niponicum	Athyriaceae
Athyrium_sheareri	Athyriaceae
Athyrium_cumingianum	Athyriaceae
Athyrium_cuspidatum	Athyriaceae
Athyrium_skinneri	Athyriaceae
Athyrium_brevifrons	Athyriaceae
Athyrium_filix_femina	Athyriaceae
Athyrium_melanolepis	Athyriaceae
Athyrium_tashiroi	Athyriaceae
Athyrium_kirisimaense	Athyriaceae
Athyrium_yokoscense	Athyriaceae
Athyrium_nikkoense	Athyriaceae
Athyrium_rupestre	Athyriaceae
Athyrium_spinulosum	Athyriaceae
Athyrium_yui	Athyriaceae
Athyrium_supraspinescens	Athyriaceae
Athyrium_nigripes	Athyriaceae
Athyrium_tozanense	Athyriaceae
Athyrium_fangii	Athyriaceae
Athyrium_silvicola	Athyriaceae
Athyrium_scandicinum	Athyriaceae
Athyrium_clarkei	Athyriaceae
Athyrium_epirachis	Athyriaceae
Athyrium_eremicola	Athyriaceae
Athyrium_clivicola	Athyriaceae
Athyrium_pubicostatum	Athyriaceae
Athyrium_kuratae	Athyriaceae
Athyrium_subrigescens	Athyriaceae
Athyrium_otophorum	Athyriaceae
Athyrium_oblitescens	Athyriaceae
Athyrium_viridescentipes	Athyriaceae
Athyrium_masamunei	Athyriaceae
Athyrium_setuligerum	Athyriaceae
Athyrium_iseanum	Athyriaceae
Athyrium_arisanense	Athyriaceae
Athyrium_chingianum	Athyriaceae
Athyrium_cryptogrammoides	Athyriaceae
Athyrium_amoenum	Athyriaceae
Athyrium_nyalamense	Athyriaceae
Athyrium_rhachidosorum	Athyriaceae
Athyrium_clemensiae	Athyriaceae
Athyrium_strigillosum	Athyriaceae
Athyrium_frangulum	Athyriaceae
Athyrium_subtriangulare	Athyriaceae
Athyrium_pinetorum	Athyriaceae
Athyrium_deltoidofrons	Athyriaceae
Athyrium_vidalii	Athyriaceae
Athyrium_palustre	Athyriaceae
Athyrium_reflexipinnum	Athyriaceae
Athyrium_wardii	Athyriaceae
Athyrium_nakanoi	Athyriaceae
Athyrium_atkinsonii	Athyriaceae
Athyrium_biserrulatum	Athyriaceae
Athyrium_distentifolium	Athyriaceae
Cornopteris_christenseniana	Athyriaceae
Cornopteris_decurrenti_alata	Athyriaceae
Cornopteris_banahaoensis	Athyriaceae
Cornopteris_crenulatoserrulata	Athyriaceae
Deparia_unifurcata	Athyriaceae
Deparia_formosana	Athyriaceae
Deparia_allantodioides	Athyriaceae
Deparia_orientalis	Athyriaceae
Athyrium_giraldii	Athyriaceae
Lunathyrium_shennongense	Athyriaceae
Athyrium_dolosa	Athyriaceae
Deparia_acrostichoides	Athyriaceae
Dryoathyrium_erectum	Athyriaceae
Deparia_pycnosora	Athyriaceae
Deparia_dickasonii	Athyriaceae
Deparia_minamitanii	Athyriaceae
Deparia_omeiensis	Athyriaceae
Athyriopsis_concinna	Athyriaceae
Deparia_tomitaroana	Athyriaceae
Deparia_lancea	Athyriaceae
Deparia_otomasui	Athyriaceae
Deparia_bonincola	Athyriaceae
Deparia_longipes	Athyriaceae
Deparia_tenuifolia	Athyriaceae
Deparia_japonica	Athyriaceae
Deparia_petersenii	Athyriaceae
Deparia_pseudoconilii	Athyriaceae
Deparia_confluens	Athyriaceae
Deparia_dimorphophylla	Athyriaceae
Deparia_biserialis	Athyriaceae
Deparia_lobatocrenata	Athyriaceae
Deparia_kiusiana	Athyriaceae
Deparia_conilii	Athyriaceae
Deparia_viridifrons	Athyriaceae
Deparia_coreana	Athyriaceae
Deparia_okuboana	Athyriaceae
Dryoathyrium_henryi	Athyriaceae
Deparia_boryana	Athyriaceae
Deparia_subfluvialis	Athyriaceae
Deparia_pterorachis	Athyriaceae
Woodwardia_japonica	Blechnaceae
Woodwardia_auriculata	Blechnaceae
Woodwardia_martinezii	Blechnaceae
Woodwardia_harlandii	Blechnaceae
Woodwardia_radicans	Blechnaceae
Woodwardia_unigemmata	Blechnaceae
Woodwardia_himalaica	Blechnaceae
Woodwardia_spinulosa	Blechnaceae
Woodwardia_fimbriata	Blechnaceae
Woodwardia_prolifera	Blechnaceae
Woodwardia_magnifica	Blechnaceae
Woodwardia_orientalis	Blechnaceae
Woodwardia_virginica	Blechnaceae
Woodwardia_areolata	Blechnaceae
Brainea_insignis	Blechnaceae
Blechnum_niponicum	Blechnaceae
Blechnum_hancockii	Blechnaceae
Blechnum_orientale	Blechnaceae
Blechnum_amabile	Blechnaceae
Blechnum_eburneum	Blechnaceae
Blechnum_contiguum	Blechnaceae
Blechnum_fragile	Blechnaceae
Blechnum_binervatum	Blechnaceae
Blechnum_ensiforme	Blechnaceae
Blechnum_kunthianum	Blechnaceae
Blechnum_fuscosquamosum	Blechnaceae
Blechnum_schomburgkii	Blechnaceae
Blechnum_tabulare	Blechnaceae
Blechnum_moritzianum	Blechnaceae
Blechnum_magellanicum	Blechnaceae
Blechnum_reticulatum	Blechnaceae
Blechnum_diversifolium	Blechnaceae
Blechnum_lenormandii	Blechnaceae
Blechnum_neglectum	Blechnaceae
Blechnum_fraseri	Blechnaceae
Blechnum_christii	Blechnaceae
Blechnum_chiriquanum	Blechnaceae
Blechnum_wurunuran	Blechnaceae
Blechnum_camfieldii	Blechnaceae
Blechnum_wattsii	Blechnaceae
Blechnum_vestitum	Blechnaceae
Blechnum_ambiguum	Blechnaceae
Blechnum_procerum	Blechnaceae
Blechnum_gregsonii	Blechnaceae
Blechnum_subcordatum	Blechnaceae
Blechnum_corbassonii	Blechnaceae
Blechnum_novae_zelandiae	Blechnaceae
Blechnum_capense	Blechnaceae
Blechnum_minus	Blechnaceae
Blechnum_howeanum	Blechnaceae
Blechnum_triangularifolium	Blechnaceae
Blechnum_montanum	Blechnaceae
Blechnum_milnei	Blechnaceae
Blechnum_cordatum	Blechnaceae
Blechnum_loxense	Blechnaceae
Blechnum_stipitellatum	Blechnaceae
Blechnum_schiedeanum	Blechnaceae
Blechnum_chilense	Blechnaceae
Blechnum_marginatum	Blechnaceae
Blechnum_articulatum	Blechnaceae
Blechnum_zeelandicum	Blechnaceae
Blechnum_molle	Blechnaceae
Blechnum_lineare	Blechnaceae
Blechnum_doodianum	Blechnaceae
Blechnum_kermadecense	Blechnaceae
Blechnum_dissectum	Blechnaceae
Blechnum_brackenridgei	Blechnaceae
Blechnum_spinulosum	Blechnaceae
Blechnum_medium	Blechnaceae
Blechnum_norfolkense	Blechnaceae
Blechnum_parrisii	Blechnaceae
Blechnum_neohollandicum	Blechnaceae
Blechnum_moorei	Blechnaceae
Blechnum_gibbum	Blechnaceae
Blechnum_vittatum	Blechnaceae
Blechnum_obtusatum	Blechnaceae
Blechnum_cartilagineum	Blechnaceae
Blechnum_whelanii	Blechnaceae
Blechnum_maximum	Blechnaceae
Blechnum_brasiliense	Blechnaceae
Blechnum_punctulatum	Blechnaceae
Blechnum_gracile	Blechnaceae
Blechnum_occidentale	Blechnaceae
Blechnum_appendiculatum	Blechnaceae
Blechnum_glandulosum	Blechnaceae
Blechnum_polypodioides	Blechnaceae
Blechnum_hastatum	Blechnaceae
Blechnum_australe	Blechnaceae
Blechnum_austrobrasilianum	Blechnaceae
Blechnum_laevigatum	Blechnaceae
Blechnum_colensoi	Blechnaceae
Blechnum_melanocaulon	Blechnaceae
Blechnum_coriaceum	Blechnaceae
Blechnum_patersonii	Blechnaceae
Blechnum_vieillardii	Blechnaceae
Blechnum_membranaceum	Blechnaceae
Blechnum_chambersii	Blechnaceae
Blechnum_norfolkianum	Blechnaceae
Blechnum_doodioides	Blechnaceae
Blechnum_divergens	Blechnaceae
Blechnum_lehmannii	Blechnaceae
Blechnum_blechnoides	Blechnaceae
Blechnum_durum	Blechnaceae
Blechnum_mochaenum	Blechnaceae
Blechnum_microphyllum	Blechnaceae
Blechnum_penna_marina	Blechnaceae
Blechnum_sprucei	Blechnaceae
Blechnum_hirsutum	Blechnaceae
Blechnum_pilosum	Blechnaceae
Blechnum_vulcanicum	Blechnaceae
Blechnum_fluviatile	Blechnaceae
Blechnum_fullagari	Blechnaceae
Blechnum_nigrum	Blechnaceae
Blechnum_opacum	Blechnaceae
Blechnum_sampaioanum	Blechnaceae
Blechnum_filiforme	Blechnaceae
Blechnum_discolor	Blechnaceae
Blechnum_nudum	Blechnaceae
Blechnum_oceanicum	Blechnaceae
Blechnum_attenuatum	Blechnaceae
Blechnum_simillimum	Blechnaceae
Blechnum_microbasis	Blechnaceae
Blechnum_spicant	Blechnaceae
Blechnum_castaneum	Blechnaceae
Sadleria_unisora	Blechnaceae
Sadleria_squarrosa	Blechnaceae
Sadleria_cyatheoides	Blechnaceae
Sadleria_souleytiana	Blechnaceae
Sadleria_pallida	Blechnaceae
Blechnum_finlaysonianum	Blechnaceae
Telmatoblechnum_indicum	Blechnaceae
Telmatoblechnum_serrulatum	Blechnaceae
Stenochlaena_milnei	Blechnaceae
Stenochlaena_tenuifolia	Blechnaceae
Stenochlaena_palustris	Blechnaceae
Salpichlaena_volubilis	Blechnaceae
Salpichlaena_hookeriana	Blechnaceae
Salpichlaena_thalassica	Blechnaceae
Matteuccia_struthiopteris	Onocleaceae
Onocleopsis_hintonii	Onocleaceae
Onoclea_sensibilis	Onocleaceae
Pentarhizidium_intermedium	Onocleaceae
Pentarhizidium_orientale	Onocleaceae
Woodsia_alpina	Woodsiaceae
Woodsia_shensiensis	Woodsiaceae
Woodsia_glabella	Woodsiaceae
Woodsia_andersonii	Woodsiaceae
Woodsia_ilvensis	Woodsiaceae
Woodsia_intermedia	Woodsiaceae
Woodsia_subcordata	Woodsiaceae
Woodsia_polystichoides	Woodsiaceae
Woodsia_macrochlaena	Woodsiaceae
Woodsia_rosthorniana	Woodsiaceae
Woodsia_lanosa	Woodsiaceae
Woodsia_cycloloba	Woodsiaceae
Woodsia_obtusa	Woodsiaceae
Woodsia_plummerae	Woodsiaceae
Woodsia_montevidensis	Woodsiaceae
Woodsia_mollis	Woodsiaceae
Woodsia_indusiosa	Woodsiaceae
Woodsia_elongata	Woodsiaceae
Woodsia_kangdingensis	Woodsiaceae
Woodsia_manchuriensis	Woodsiaceae
Oreopteris_limbosperma	Thelypteridaceae
Oreopteris_quelpaertensis	Thelypteridaceae
Stegnogramma_cyrtomioides	Thelypteridaceae
Stegnogramma_latipinna	Thelypteridaceae
Stegnogramma_himalaica	Thelypteridaceae
Stegnogramma_gymnocarpa	Thelypteridaceae
Stegnogramma_tottoides	Thelypteridaceae
Leptogramma_centrochinensis	Thelypteridaceae
Stegnogramma_pozoi	Thelypteridaceae
Dictyocline_sagittifolia	Thelypteridaceae
Dictyocline_mingchegensis	Thelypteridaceae
Stegnogramma_wilfordii	Thelypteridaceae
Dictyocline_griffithii	Thelypteridaceae
Cyclogramma_auriculata	Thelypteridaceae
Cyclogramma_omeiensis	Thelypteridaceae
Cyclogramma_flexilis	Thelypteridaceae
Thelypteris_clypeolutata	Thelypteridaceae
Thelypteris_glandulosa	Thelypteridaceae
Meniscium_arcanum	Thelypteridaceae
Thelypteris_reticulata	Thelypteridaceae
Meniscium_serratum	Thelypteridaceae
Meniscium_angustifolium	Thelypteridaceae
Meniscium_macrophyllum	Thelypteridaceae
Meniscium_chrysodioides	Thelypteridaceae
Meniscium_salzmannii	Thelypteridaceae
Meniscium_arborescens	Thelypteridaceae
Meniscium_longifolium	Thelypteridaceae
Meniscium_membranaceum	Thelypteridaceae
Ampelopteris_prolifera	Thelypteridaceae
Mesophlebion_crassifolium	Thelypteridaceae
Cyclosorus_interruptus	Thelypteridaceae
Thelypteris_ovata	Thelypteridaceae
Glaphyropteridopsis_rufostraminea	Thelypteridaceae
Glaphyropteridopsis_erubescens	Thelypteridaceae
Pneumatopteris_ecallosa	Thelypteridaceae
Thelypteris_longissima	Thelypteridaceae
Thelypteris_liukiuensis	Thelypteridaceae
Pronephrium_megacuspe	Thelypteridaceae
Pronephrium_triphyllum	Thelypteridaceae
Pronephrium_parishii	Thelypteridaceae
Pronephrium_simplex	Thelypteridaceae
Chingia_longissima	Thelypteridaceae
Pronephrium_penangianum	Thelypteridaceae
Pronephrium_lakhimpurense	Thelypteridaceae
Christella_augescens	Thelypteridaceae
Christella_patens	Thelypteridaceae
Christella_calvescens	Thelypteridaceae
Thelypteris_jaculosa	Thelypteridaceae
Christella_arida	Thelypteridaceae
Christella_latipinna	Thelypteridaceae
Christella_subpubescens	Thelypteridaceae
Christella_subelata	Thelypteridaceae
Christella_crinipes	Thelypteridaceae
Christella_scaberula	Thelypteridaceae
Christella_hispidula	Thelypteridaceae
Christella_conspersa	Thelypteridaceae
Cyclosorus_nanxiensis	Thelypteridaceae
Thelypteris_boninensis	Thelypteridaceae
Christella_dentata	Thelypteridaceae
Cyclosorus_parasiticus	Thelypteridaceae
Christella_molliuscula	Thelypteridaceae
Christella_procurrens	Thelypteridaceae
Christella_papilio	Thelypteridaceae
Thelypteris_acuminata	Thelypteridaceae
Sphaerostephanos_elatus	Thelypteridaceae
Pronephrium_nudatum	Thelypteridaceae
Thelypteris_affinis	Thelypteridaceae
Pronephrium_gymnopteridifrons	Thelypteridaceae
Thelypteris_opulenta	Thelypteridaceae
Trigonospora_ciliata	Thelypteridaceae
Pseudocyclosorus_tuberculifer	Thelypteridaceae
Thelypteris_tylodes	Thelypteridaceae
Pseudocyclosorus_submarginalis	Thelypteridaceae
Pseudocyclosorus_subochthodes	Thelypteridaceae
Pseudocyclosorus_falcilobus	Thelypteridaceae
Thelypteris_esquirolii	Thelypteridaceae
Pronephrium_articulatum	Thelypteridaceae
Thelypteris_truncata	Thelypteridaceae
Sphaerostephanos_taiwanensis	Thelypteridaceae
Sphaerostephanos_heterocarpus	Thelypteridaceae
Sphaerostephanos_arbuscula	Thelypteridaceae
Sphaerostephanos_penniger	Thelypteridaceae
Sphaerostephanos_polycarpus	Thelypteridaceae
Sphaerostephanos_larutensis	Thelypteridaceae
Nannothelypteris_aoristisora	Thelypteridaceae
Sphaerostephanos_unitus	Thelypteridaceae
Plesioneuron_archboldiae	Thelypteridaceae
Mesopteris_tonkinensis	Thelypteridaceae
Thelypteris_gemmulifera	Thelypteridaceae
Thelypteris_abrupta	Thelypteridaceae
Thelypteris_meniscioides	Thelypteridaceae
Goniopteris_pennata	Thelypteridaceae
Goniopteris_biolleyi	Thelypteridaceae
Goniopteris_juruensis	Thelypteridaceae
Goniopteris_tristis	Thelypteridaceae
Goniopteris_vivipara	Thelypteridaceae
Goniopteris_goeldii	Thelypteridaceae
Goniopteris_scabra	Thelypteridaceae
Goniopteris_lugubris	Thelypteridaceae
Goniopteris_poiteana	Thelypteridaceae
Goniopteris_tetragona	Thelypteridaceae
Thelypteris_polypodioides	Thelypteridaceae
Thelypteris_hatschbachii	Thelypteridaceae
Thelypteris_decussata	Thelypteridaceae
Thelypteris_comosa	Thelypteridaceae
Steiropteris_leprieurii	Thelypteridaceae
Steiropteris_valdepilosa	Thelypteridaceae
Steiropteris_gardneriana	Thelypteridaceae
Parathelypteris_noveboracensis	Thelypteridaceae
Thelypteris_nevadensis	Thelypteridaceae
Thelypteris_linkiana	Thelypteridaceae
Thelypteris_rustica	Thelypteridaceae
Thelypteris_juergensii	Thelypteridaceae
Thelypteris_eriosora	Thelypteridaceae
Thelypteris_pachyrachis	Thelypteridaceae
Amauropelta_cheilanthoides	Thelypteridaceae
Thelypteris_globulifera	Thelypteridaceae
Amauropelta_heteroptera	Thelypteridaceae
Amauropelta_salazica	Thelypteridaceae
Amauropelta_tomentosa	Thelypteridaceae
Amauropelta_bergiana	Thelypteridaceae
Amauropelta_strigosa	Thelypteridaceae
Thelypteris_saxicola	Thelypteridaceae
Amauropelta_oppositiformis	Thelypteridaceae
Thelypteris_burkartii	Thelypteridaceae
Thelypteris_raddii	Thelypteridaceae
Amauropelta_retusa	Thelypteridaceae
Thelypteris_rivularioides	Thelypteridaceae
Thelypteris_regnelliana	Thelypteridaceae
Amauropelta_ptarmica	Thelypteridaceae
Thelypteris_amambayensis	Thelypteridaceae
Amauropelta_oligocarpa	Thelypteridaceae
Thelypteris_decurtata	Thelypteridaceae
Thelypteris_oligocarpa	Thelypteridaceae
Thelypteris_gracilis	Thelypteridaceae
Thelypteris_nipponica	Thelypteridaceae
Thelypteris_beddomei	Thelypteridaceae
Thelypteris_consanguinea	Thelypteridaceae
Parathelypteris_glanduligera	Thelypteridaceae
Thelypteris_miyagii	Thelypteridaceae
Thelypteris_cystopteroides	Thelypteridaceae
Thelypteris_angustifrons	Thelypteridaceae
Thelypteris_dayi	Thelypteridaceae
Metathelypteris_singalanensis	Thelypteridaceae
Thelypteris_uraiensis	Thelypteridaceae
Metathelypteris_hattorii	Thelypteridaceae
Thelypteris_laxa	Thelypteridaceae
Metathelypteris_glandulifera	Thelypteridaceae
Metathelypteris_flaccida	Thelypteridaceae
Thelypteris_gracilescens	Thelypteridaceae
Coryphopteris_seemannii	Thelypteridaceae
Coryphopteris_hirsutipes	Thelypteridaceae
Parathelypteris_nigrescens	Thelypteridaceae
Thelypteris_angulariloba	Thelypteridaceae
Coryphopteris_petelotii	Thelypteridaceae
Parathelypteris_chinensis	Thelypteridaceae
Coryphopteris_pectiniformis	Thelypteridaceae
Thelypteris_musashiensis	Thelypteridaceae
Thelypteris_castanea	Thelypteridaceae
Thelypteris_japonica	Thelypteridaceae
Thelypteris_palustris	Thelypteridaceae
Phegopteris_connectilis	Thelypteridaceae
Phegopteris_hexagonoptera	Thelypteridaceae
Phegopteris_koreana	Thelypteridaceae
Phegopteris_decursivipinnata	Thelypteridaceae
Pseudophegopteris_tibetana	Thelypteridaceae
Pseudophegopteris_pyrrhorachis	Thelypteridaceae
Thelypteris_subaurita	Thelypteridaceae
Pseudophegopteris_zayuensis	Thelypteridaceae
Pseudophegopteris_yunkweiensis	Thelypteridaceae
Pseudophegopteris_hirtirachis	Thelypteridaceae
Pseudophegopteris_paludosa	Thelypteridaceae
Pseudophegopteris_microstegia	Thelypteridaceae
Pseudophegopteris_cruciata	Thelypteridaceae
Pseudophegopteris_brevipes	Thelypteridaceae
Thelypteris_aurita	Thelypteridaceae
Pseudophegopteris_levingei	Thelypteridaceae
Thelypteris_bukoensis	Thelypteridaceae
Thelypteris_viridifrons	Thelypteridaceae
Macrothelypteris_torresiana	Thelypteridaceae
Thelypteris_ogasawarensis	Thelypteridaceae
Macrothelypteris_polypodioides	Thelypteridaceae
Macrothelypteris_ornata	Thelypteridaceae
Rhachidosorus_consimilis	Rhachidosoraceae
Rhachidosorus_pulcher	Rhachidosoraceae
Rhachidosorus_blotianus	Rhachidosoraceae
Rhachidosorus_mesosorus	Rhachidosoraceae
Asplenium_aegaeum	Aspleniaceae
Asplenium_fissum	Aspleniaceae
Asplenium_pteropus	Aspleniaceae
Asplenium_alatum	Aspleniaceae
Asplenium_myriophyllum	Aspleniaceae
Asplenium_cristatum	Aspleniaceae
Asplenium_erectum	Aspleniaceae
Asplenium_dognyense	Aspleniaceae
Asplenium_lunulatum	Aspleniaceae
Asplenium_harpeodes	Aspleniaceae
Asplenium_stoloniferum	Aspleniaceae
Asplenium_fragile	Aspleniaceae
Asplenium_abscissum	Aspleniaceae
Asplenium_hostmannii	Aspleniaceae
Asplenium_marinum	Aspleniaceae
Asplenium_majoricum	Aspleniaceae
Asplenium_petrarchae	Aspleniaceae
Asplenium_dalhousiae	Aspleniaceae
Asplenium_parvifolium	Aspleniaceae
Asplenium_lolegnamense	Aspleniaceae
Asplenium_octoploideum	Aspleniaceae
Asplenium_aureum	Aspleniaceae
Asplenium_punjabense	Aspleniaceae
Asplenium_ceterach	Aspleniaceae
Asplenium_hybridum	Aspleniaceae
Asplenium_cyprium	Aspleniaceae
Asplenium_paucivenosum	Aspleniaceae
Asplenium_scolopendrium	Aspleniaceae
Asplenium_sagittatum	Aspleniaceae
Asplenium_ritoense	Aspleniaceae
Asplenium_wrightioides	Aspleniaceae
Asplenium_wrightii	Aspleniaceae
Asplenium_bullatum	Aspleniaceae
Asplenium_petiolulatum	Aspleniaceae
Asplenium_praegracile	Aspleniaceae
Asplenium_actinopteroides	Aspleniaceae
Asplenium_aethiopicum	Aspleniaceae
Asplenium_decompositum	Aspleniaceae
Asplenium_praemorsum	Aspleniaceae
Asplenium_sulcatum	Aspleniaceae
Asplenium_nitens	Aspleniaceae
Asplenium_parvum	Aspleniaceae
Asplenium_filidens	Aspleniaceae
Asplenium_micantifrons	Aspleniaceae
Asplenium_contiguum	Aspleniaceae
Asplenium_friesiorum	Aspleniaceae
Asplenium_protensum	Aspleniaceae
Asplenium_volkensii	Aspleniaceae
Asplenium_hemitomum	Aspleniaceae
Asplenium_lividum	Aspleniaceae
Asplenium_majus	Aspleniaceae
Asplenium_ensiforme	Aspleniaceae
Asplenium_planicaule	Aspleniaceae
Asplenium_pseudowilfordii	Aspleniaceae
Asplenium_wilfordii	Aspleniaceae
Asplenium_crinicaule	Aspleniaceae
Asplenium_yoshinagae	Aspleniaceae
Asplenium_finlaysonianum	Aspleniaceae
Asplenium_polyodon	Aspleniaceae
Asplenium_listeri	Aspleniaceae
Asplenium_paleaceum	Aspleniaceae
Asplenium_attenuatum	Aspleniaceae
Asplenium_carnarvonense	Aspleniaceae
Asplenium_bicentenniale	Aspleniaceae
Asplenium_laserpitiifolium	Aspleniaceae
Asplenium_pseudolaserpitiifolium	Aspleniaceae
Asplenium_capitisyork	Aspleniaceae
Asplenium_keysserianum	Aspleniaceae
Asplenium_setisectum	Aspleniaceae
Asplenium_sphenotomum	Aspleniaceae
Asplenium_cromwellianum	Aspleniaceae
Asplenium_insiticium	Aspleniaceae
Asplenium_cuneatum	Aspleniaceae
Asplenium_nitidum	Aspleniaceae
Asplenium_affine	Aspleniaceae
Asplenium_athertonense	Aspleniaceae
Asplenium_baileyanum	Aspleniaceae
Asplenium_lobulatum	Aspleniaceae
Asplenium_cuneatiforme	Aspleniaceae
Asplenium_novoguineense	Aspleniaceae
Asplenium_caudatum	Aspleniaceae
Asplenium_longissimum	Aspleniaceae
Asplenium_pellucidum	Aspleniaceae
Diellia_pallida	Aspleniaceae
Diellia_falcata	Aspleniaceae
Diellia_unisora	Aspleniaceae
Asplenium_dielerectum	Aspleniaceae
Diellia_mannii	Aspleniaceae
Asplenium_azoricum	Aspleniaceae
Asplenium_anceps	Aspleniaceae
Asplenium_trichomanes	Aspleniaceae
Asplenium_tripteropus	Aspleniaceae
Asplenium_monanthes	Aspleniaceae
Asplenium_hallbergii	Aspleniaceae
Asplenium_palmeri	Aspleniaceae
Asplenium_resiliens	Aspleniaceae
Asplenium_heteroresiliens	Aspleniaceae
Asplenium_heterochroum	Aspleniaceae
Asplenium_castaneum	Aspleniaceae
Asplenium_soleirolioides	Aspleniaceae
Asplenium_polyphyllum	Aspleniaceae
Asplenium_fibrillosum	Aspleniaceae
Asplenium_formosum	Aspleniaceae
Asplenium_oligophlebium	Aspleniaceae
Asplenium_boreale	Aspleniaceae
Asplenium_gulingense	Aspleniaceae
Asplenium_hobdyi	Aspleniaceae
Asplenium_shimurae	Aspleniaceae
Asplenium_normale	Aspleniaceae
Asplenium_viride	Aspleniaceae
Asplenium_radicans	Aspleniaceae
Asplenium_seelosii	Aspleniaceae
Asplenium_septentrionale	Aspleniaceae
Asplenium_celtibericum	Aspleniaceae
Asplenium_bourgaei	Aspleniaceae
Asplenium_jahandiezii	Aspleniaceae
Asplenium_ruprechtii	Aspleniaceae
Asplenium_rhizophyllum	Aspleniaceae
Asplenium_dareoides	Aspleniaceae
Asplenium_cordatum	Aspleniaceae
Asplenium_phillipsianum	Aspleniaceae
Asplenium_haughtonii	Aspleniaceae
Asplenium_tenuicaule	Aspleniaceae
Asplenium_anogrammoides	Aspleniaceae
Asplenium_sarelii	Aspleniaceae
Asplenium_pekinense	Aspleniaceae
Asplenium_capillipes	Aspleniaceae
Asplenium_kukkonenii	Aspleniaceae
Asplenium_varians	Aspleniaceae
Asplenium_laciniatum	Aspleniaceae
Asplenium_lushanense	Aspleniaceae
Asplenium_exiguum	Aspleniaceae
Asplenium_yunnanense	Aspleniaceae
Asplenium_coenobiale	Aspleniaceae
Asplenium_interjectum	Aspleniaceae
Asplenium_billotii	Aspleniaceae
Asplenium_foresiense	Aspleniaceae
Asplenium_incisum	Aspleniaceae
Asplenium_fontanum	Aspleniaceae
Asplenium_platyneuron	Aspleniaceae
Asplenium_hemionitis	Aspleniaceae
Asplenium_pauperequitum	Aspleniaceae
Asplenium_flabellifolium	Aspleniaceae
Asplenium_hispanicum	Aspleniaceae
Asplenium_papaverifolium	Aspleniaceae
Asplenium_subglandulosum	Aspleniaceae
Asplenium_ruta_muraria	Aspleniaceae
Asplenium_cuneifolium	Aspleniaceae
Asplenium_adiantum_nigrum	Aspleniaceae
Asplenium_montanum	Aspleniaceae
Asplenium_onopteris	Aspleniaceae
Asplenium_marattioides	Aspleniaceae
Asplenium_scandens	Aspleniaceae
Asplenium_surrogatum	Aspleniaceae
Asplenium_pteridoides	Aspleniaceae
Asplenium_milnei	Aspleniaceae
Asplenium_hookerianum	Aspleniaceae
Asplenium_richardii	Aspleniaceae
Asplenium_cimmeriorum	Aspleniaceae
Asplenium_bulbiferum	Aspleniaceae
Asplenium_daucifolium	Aspleniaceae
Asplenium_mauritiensis	Aspleniaceae
Asplenium_appendiculatum	Aspleniaceae
Asplenium_chathamense	Aspleniaceae
Asplenium_lamprophyllum	Aspleniaceae
Asplenium_difforme	Aspleniaceae
Asplenium_dimorphum	Aspleniaceae
Asplenium_stenolobum	Aspleniaceae
Asplenium_gibberosum	Aspleniaceae
Asplenium_subflexuosum	Aspleniaceae
Asplenium_shuttleworthianum	Aspleniaceae
Asplenium_flaccidum	Aspleniaceae
Asplenium_polyphyleticum	Aspleniaceae
Asplenium_oblongifolium	Aspleniaceae
Asplenium_scleropium	Aspleniaceae
Asplenium_obliquum	Aspleniaceae
Asplenium_obtusatum	Aspleniaceae
Asplenium_northlandicum	Aspleniaceae
Asplenium_lyallii	Aspleniaceae
Asplenium_oligolepidum	Aspleniaceae
Asplenium_vieillardii	Aspleniaceae
Asplenium_lucidum	Aspleniaceae
Asplenium_trigonopterum	Aspleniaceae
Asplenium_antrophyoides	Aspleniaceae
Asplenium_cymbifolium	Aspleniaceae
Asplenium_antiquum	Aspleniaceae
Asplenium_subemarginatum	Aspleniaceae
Asplenium_squamulatum	Aspleniaceae
Asplenium_griffithianum	Aspleniaceae
Asplenium_scalare	Aspleniaceae
Asplenium_vulcanicum	Aspleniaceae
Asplenium_decorum	Aspleniaceae
Asplenium_thunbergii	Aspleniaceae
Asplenium_tenuiculum	Aspleniaceae
Asplenium_bipartitum	Aspleniaceae
Asplenium_tenerum	Aspleniaceae
Asplenium_carruthersii	Aspleniaceae
Asplenium_loriceum	Aspleniaceae
Asplenium_prolongatum	Aspleniaceae
Asplenium_mannii	Aspleniaceae
Asplenium_variabile	Aspleniaceae
Asplenium_dregeanum	Aspleniaceae
Asplenium_preussii	Aspleniaceae
Asplenium_sandersonii	Aspleniaceae
Asplenium_christii	Aspleniaceae
Asplenium_gemmiferum	Aspleniaceae
Asplenium_compressum	Aspleniaceae
Asplenium_elliottii	Aspleniaceae
Asplenium_boltonii	Aspleniaceae
Asplenium_anisophyllum	Aspleniaceae
Asplenium_feei	Aspleniaceae
Asplenium_smedsii	Aspleniaceae
Asplenium_theciferum	Aspleniaceae
Asplenium_loxoscaphoides	Aspleniaceae
Asplenium_rutifolium	Aspleniaceae
Asplenium_emarginatum	Aspleniaceae
Asplenium_serratum	Aspleniaceae
Asplenium_angustum	Aspleniaceae
Asplenium_bipinnatifidum	Aspleniaceae
Asplenium_amboinense	Aspleniaceae
Asplenium_simplicifrons	Aspleniaceae
Asplenium_currorii	Aspleniaceae
Asplenium_australasicum	Aspleniaceae
Asplenium_harmanii	Aspleniaceae
Asplenium_goudeyi	Aspleniaceae
Asplenium_setoi	Aspleniaceae
Asplenium_nidus	Aspleniaceae
Asplenium_phyllitidis	Aspleniaceae
Asplenium_tricholepis	Aspleniaceae
Asplenium_juglandifolium	Aspleniaceae
Asplenium_pearcei	Aspleniaceae
Asplenium_salicifolium	Aspleniaceae
Asplenium_hastatum	Aspleniaceae
Asplenium_auriculatum	Aspleniaceae
Asplenium_auritum	Aspleniaceae
Asplenium_cuspidatum	Aspleniaceae
Asplenium_riparium	Aspleniaceae
Asplenium_laetum	Aspleniaceae
Hymenasplenium_excisum	Aspleniaceae
Asplenium_obliquissimum	Aspleniaceae
Asplenium_filipes	Aspleniaceae
Hymenasplenium_cheilosorum	Aspleniaceae
Asplenium_apogamum	Aspleniaceae
Hymenasplenium_hondoense	Aspleniaceae
Hymenasplenium_murakami_hatanakae	Aspleniaceae
Hymenasplenium_mitanii	Aspleniaceae
Hymenasplenium_cardiophyllum	Aspleniaceae
Asplenium_wildii	Aspleniaceae
Hymenasplenium_unilaterale	Aspleniaceae
Pteridium_aquilinum	Dennstaedtiaceae
Pteridium_esculentum	Dennstaedtiaceae
Pteridium_caudatum	Dennstaedtiaceae
Pteridium_semihastatum	Dennstaedtiaceae
Pteridium_revolutum	Dennstaedtiaceae
Paesia_scaberula	Dennstaedtiaceae
Histiopteris_incisa	Dennstaedtiaceae
Blotiella_pubescens	Dennstaedtiaceae
Blotiella_glabra	Dennstaedtiaceae
Hypolepis_punctata	Dennstaedtiaceae
Hypolepis_tenuifolia	Dennstaedtiaceae
Hypolepis_millefolium	Dennstaedtiaceae
Hypolepis_goetzei	Dennstaedtiaceae
Hypolepis_hostilis	Dennstaedtiaceae
Monachosorum_flagellare	Dennstaedtiaceae
Monachosorum_arakii	Dennstaedtiaceae
Monachosorum_henryi	Dennstaedtiaceae
Monachosorum_maximowiczii	Dennstaedtiaceae
Coptidipteris_wilfordii	Dennstaedtiaceae
Dennstaedtia_scabra	Dennstaedtiaceae
Dennstaedtia_punctilobula	Dennstaedtiaceae
Dennstaedtia_hirsuta	Dennstaedtiaceae
Microlepia_hookeriana	Dennstaedtiaceae
Microlepia_pseudostrigosa	Dennstaedtiaceae
Microlepia_szechuanica	Dennstaedtiaceae
Microlepia_strigosa	Dennstaedtiaceae
Microlepia_izu_peninsulae	Dennstaedtiaceae
Microlepia_obtusiloba	Dennstaedtiaceae
Microlepia_substrigosa	Dennstaedtiaceae
Microlepia_marginata	Dennstaedtiaceae
Microlepia_platyphylla	Dennstaedtiaceae
Microlepia_speluncae	Dennstaedtiaceae
Dennstaedtia_dissecta	Dennstaedtiaceae
Dennstaedtia_samoensis	Dennstaedtiaceae
Leptolepia_novae_zelandiae	Dennstaedtiaceae
Nesolindsaea_kirkii	Lindsaeaceae
Nesolindsaea_caudata	Lindsaeaceae
Lindsaea_microphylla	Lindsaeaceae
Lindsaea_botrychioides	Lindsaeaceae
Lindsaea_ovoidea	Lindsaeaceae
Lindsaea_imrayana	Lindsaeaceae
Lindsaea_rufa	Lindsaeaceae
Lindsaea_trichomanoides	Lindsaeaceae
Lindsaea_bifida	Lindsaeaceae
Lindsaea_virescens	Lindsaeaceae
Lindsaea_portoricensis	Lindsaeaceae
Lindsaea_surinamensis	Lindsaeaceae
Lindsaea_pallida	Lindsaeaceae
Lindsaea_dubia	Lindsaeaceae
Lindsaea_ulei	Lindsaeaceae
Lindsaea_hemiglossa	Lindsaeaceae
Lindsaea_arcuata	Lindsaeaceae
Lindsaea_coarctata	Lindsaeaceae
Lindsaea_digitata	Lindsaeaceae
Lindsaea_quadrangularis	Lindsaeaceae
Lindsaea_lherminieri	Lindsaeaceae
Lindsaea_bolivarensis	Lindsaeaceae
Lindsaea_taeniata	Lindsaeaceae
Lindsaea_spruceana	Lindsaeaceae
Lindsaea_sphenomeridopsis	Lindsaeaceae
Lindsaea_cyclophylla	Lindsaeaceae
Lindsaea_reniformis	Lindsaeaceae
Lindsaea_guianensis	Lindsaeaceae
Lindsaea_meifolia	Lindsaeaceae
Lindsaea_schomburgkii	Lindsaeaceae
Lindsaea_semilunata	Lindsaeaceae
Lindsaea_rigidiuscula	Lindsaeaceae
Lindsaea_pendula	Lindsaeaceae
Lindsaea_feei	Lindsaeaceae
Lindsaea_parkeri	Lindsaeaceae
Lindsaea_sagittata	Lindsaeaceae
Lindsaea_tenuis	Lindsaeaceae
Lindsaea_stricta	Lindsaeaceae
Lindsaea_divaricata	Lindsaeaceae
Lindsaea_hemiptera	Lindsaeaceae
Lindsaea_tetraptera	Lindsaeaceae
Lindsaea_phassa	Lindsaeaceae
Lindsaea_klotzschiana	Lindsaeaceae
Lindsaea_cubensis	Lindsaeaceae
Lindsaea_hamiguitanensis	Lindsaeaceae
Lindsaea_bouillodii	Lindsaeaceae
Lindsaea_orbiculata	Lindsaeaceae
Lindsaea_heterophylla	Lindsaeaceae
Lindsaea_simulans	Lindsaeaceae
Lindsaea_cambodgensis	Lindsaeaceae
Lindsaea_kawabatae	Lindsaeaceae
Lindsaea_repanda	Lindsaeaceae
Lindsaea_annamensis	Lindsaeaceae
Lindsaea_chienii	Lindsaeaceae
Lindsaea_austrosinica	Lindsaeaceae
Lindsaea_dissectiformis	Lindsaeaceae
Lindsaea_grandiareolata	Lindsaeaceae
Lindsaea_javanensis	Lindsaeaceae
Lindsaea_vieillardii	Lindsaeaceae
Lindsaea_gomphophylla	Lindsaeaceae
Lindsaea_schizophylla	Lindsaeaceae
Lindsaea_millefolia	Lindsaeaceae
Lindsaea_blotiana	Lindsaeaceae
Lindsaea_subtilis	Lindsaeaceae
Lindsaea_goudotiana	Lindsaeaceae
Lindsaea_leptophylla	Lindsaeaceae
Lindsaea_madagascariensis	Lindsaeaceae
Lindsaea_agatii	Lindsaeaceae
Lindsaea_fraseri	Lindsaeaceae
Lindsaea_media	Lindsaeaceae
Lindsaea_oxyphylla	Lindsaeaceae
Lindsaea_ensifolia	Lindsaeaceae
Lindsaea_walkerae	Lindsaeaceae
Lindsaea_prolongata	Lindsaeaceae
Lindsaea_nervosa	Lindsaeaceae
Lindsaea_linearis	Lindsaeaceae
Lindsaea_oblanceolata	Lindsaeaceae
Lindsaea_repens	Lindsaeaceae
Lindsaea_pectinata	Lindsaeaceae
Lindsaea_apoensis	Lindsaeaceae
Lindsaea_carvifolia	Lindsaeaceae
Lindsaea_pseudohemiptera	Lindsaeaceae
Lindsaea_sessilis	Lindsaeaceae
Lindsaea_borneensis	Lindsaeaceae
Lindsaea_doryphora	Lindsaeaceae
Lindsaea_parasitica	Lindsaeaceae
Lindsaea_rosenstockii	Lindsaeaceae
Lindsaea_regularis	Lindsaeaceae
Lindsaea_lobata	Lindsaeaceae
Lindsaea_integra	Lindsaeaceae
Lindsaea_cultrata	Lindsaeaceae
Lindsaea_harveyi	Lindsaeaceae
Lindsaea_hainanensis	Lindsaeaceae
Lindsaea_crispa	Lindsaeaceae
Lindsaea_malayensis	Lindsaeaceae
Lindsaea_venusta	Lindsaeaceae
Lindsaea_longifolia	Lindsaeaceae
Lindsaea_parallelogramma	Lindsaeaceae
Lindsaea_multisora	Lindsaeaceae
Lindsaea_tetragona	Lindsaeaceae
Lindsaea_polyctena	Lindsaeaceae
Lindsaea_tenuifolia	Lindsaeaceae
Lindsaea_pulchella	Lindsaeaceae
Lindsaea_werneri	Lindsaeaceae
Lindsaea_vitiensis	Lindsaeaceae
Lindsaea_pickeringii	Lindsaeaceae
Lindsaea_pulchra	Lindsaeaceae
Lindsaea_stolonifera	Lindsaeaceae
Lindsaea_chrysolepis	Lindsaeaceae
Lindsaea_blanda	Lindsaeaceae
Lindsaea_obtusa	Lindsaeaceae
Lindsaea_pacifica	Lindsaeaceae
Lindsaea_propinqua	Lindsaeaceae
Lindsaea_azurea	Lindsaeaceae
Lindsaea_diplosora	Lindsaeaceae
Lindsaea_rigida	Lindsaeaceae
Lindsaea_monocarpa	Lindsaeaceae
Lindsaea_brachypoda	Lindsaeaceae
Lindsaea_lapeyrousei	Lindsaeaceae
Lindsaea_brevipes	Lindsaeaceae
Lindsaea_lucida	Lindsaeaceae
Lindsaea_kingii	Lindsaeaceae
Lindsaea_incisa	Lindsaeaceae
Lindsaea_divergens	Lindsaeaceae
Lindsaea_jamesonioides	Lindsaeaceae
Lindsaea_pellaeiformis	Lindsaeaceae
Lindsaea_gueriniana	Lindsaeaceae
Lindsaea_viridis	Lindsaeaceae
Lindsaea_plicata	Lindsaeaceae
Lindsaea_seemannii	Lindsaeaceae
Lindsaea_pratensis	Lindsaeaceae
Odontosoria_africana	Lindsaeaceae
Odontosoria_afra	Lindsaeaceae
Odontosoria_biflora	Lindsaeaceae
Odontosoria_gracilis	Lindsaeaceae
Odontosoria_chinensis	Lindsaeaceae
Odontosoria_minutula	Lindsaeaceae
Odontosoria_flexuosa	Lindsaeaceae
Odontosoria_wrightiana	Lindsaeaceae
Odontosoria_aculeata	Lindsaeaceae
Odontosoria_jenmanii	Lindsaeaceae
Odontosoria_scandens	Lindsaeaceae
Odontosoria_fumarioides	Lindsaeaceae
Odontosoria_schlechtendalii	Lindsaeaceae
Odontosoria_guatemalensis	Lindsaeaceae
Odontosoria_melleri	Lindsaeaceae
Odontosoria_retusa	Lindsaeaceae
Odontosoria_alutacea	Lindsaeaceae
Odontosoria_deltoidea	Lindsaeaceae
Sphenomeris_angustifolia	Lindsaeaceae
Sphenomeris_clavata	Lindsaeaceae
Osmolindsaea_odorata	Lindsaeaceae
Osmolindsaea_minor	Lindsaeaceae
Osmolindsaea_japonica	Lindsaeaceae
Osmolindsaea_leptolepida	Lindsaeaceae
Osmolindsaea_latisquama	Lindsaeaceae
Tapeinidium_moorei	Lindsaeaceae
Tapeinidium_novoguineense	Lindsaeaceae
Tapeinidium_denhami	Lindsaeaceae
Tapeinidium_gracile	Lindsaeaceae
Tapeinidium_pinnatum	Lindsaeaceae
Tapeinidium_luzonicum	Lindsaeaceae
Tapeinidium_calomelanos	Lindsaeaceae
Tapeinidium_longipinnulum	Lindsaeaceae
Tapeinidium_amboynense	Lindsaeaceae
Tapeinidium_melanesicum	Lindsaeaceae
Lonchitis_hirsuta	Lonchitidaceae
Lonchitis_mannii	Lonchitidaceae
Cystodium_sorbifolium	Cystodiaceae
Saccoloma_inaequale	Saccolomataceae
Orthiopteris_kingii	Saccolomataceae
Saccoloma_elegans	Saccolomataceae
Saccoloma_brasiliense	Saccolomataceae
Calochlaena_dubia	Dicksoniaceae
Calochlaena_villosa	Dicksoniaceae
Calochlaena_javanica	Dicksoniaceae
Dicksonia_baudouinii	Dicksoniaceae
Dicksonia_lanata	Dicksoniaceae
Dicksonia_squarrosa	Dicksoniaceae
Dicksonia_thyrsopteroides	Dicksoniaceae
Dicksonia_blumei	Dicksoniaceae
Dicksonia_arborescens	Dicksoniaceae
Dicksonia_antarctica	Dicksoniaceae
Dicksonia_fibrosia	Dicksoniaceae
Dicksonia_gigantea	Dicksoniaceae
Lophosoria_quadripinnata	Dicksoniaceae
Metaxya_rostrata	Metaxyaceae
Metaxya_lanosa	Metaxyaceae
Sphaeropteris_albifrons	Cyatheaceae
Sphaeropteris_polypoda	Cyatheaceae
Sphaeropteris_capitata	Cyatheaceae
Sphaeropteris_megalosora	Cyatheaceae
Sphaeropteris_quindiuensis	Cyatheaceae
Sphaeropteris_brunei	Cyatheaceae
Sphaeropteris_horrida	Cyatheaceae
Cyathea_lepifera	Cyatheaceae
Cyathea_mertensiana	Cyatheaceae
Sphaeropteris_glauca	Cyatheaceae
Sphaeropteris_robusta	Cyatheaceae
Sphaeropteris_excelsa	Cyatheaceae
Sphaeropteris_cooperi	Cyatheaceae
Sphaeropteris_aeneifolia	Cyatheaceae
Sphaeropteris_tomentosissima	Cyatheaceae
Sphaeropteris_atrox	Cyatheaceae
Sphaeropteris_medullaris	Cyatheaceae
Sphaeropteris_novaecaledoniae	Cyatheaceae
Sphaeropteris_celebica	Cyatheaceae
Cyathea_leichhardtiana	Cyatheaceae
Sphaeropteris_auriculifera	Cyatheaceae
Cyathea_parvula	Cyatheaceae
Cyathea_arborea	Cyatheaceae
Cyathea_valdecrenata	Cyatheaceae
Cyathea_stipularis	Cyatheaceae
Cyathea_tryonorum	Cyatheaceae
Cyathea_poeppigii	Cyatheaceae
Hymenophyllopsis_dejecta	Cyatheaceae
Hymenophyllopsis_hymenophylloides	Cyatheaceae
Cyathea_bradei	Cyatheaceae
Cyathea_surinamensis	Cyatheaceae
Cyathea_multiflora	Cyatheaceae
Cyathea_lasiosora	Cyatheaceae
Cyathea_gibbosa	Cyatheaceae
Cyathea_macrosora	Cyatheaceae
Cyathea_senilis	Cyatheaceae
Cyathea_pungens	Cyatheaceae
Cyathea_furfuracea	Cyatheaceae
Cyathea_mucilagina	Cyatheaceae
Cyathea_divergens	Cyatheaceae
Cyathea_caracasana	Cyatheaceae
Cyathea_weatherbyana	Cyatheaceae
Cyathea_schiedeana	Cyatheaceae
Cyathea_gracilis	Cyatheaceae
Cyathea_mutica	Cyatheaceae
Cyathea_speciosa	Cyatheaceae
Cyathea_horrida	Cyatheaceae
Cyathea_karsteniana	Cyatheaceae
Cyathea_grandifolia	Cyatheaceae
Cyathea_robertsiana	Cyatheaceae
Cyathea_howeana	Cyatheaceae
Alsophila_alata	Cyatheaceae
Alsophila_austroyunnanensis	Cyatheaceae
Alsophila_ramispina	Cyatheaceae
Alsophila_metteniana	Cyatheaceae
Cyathea_podophylla	Cyatheaceae
Cyathea_hancockii	Cyatheaceae
Cyathea_klossii	Cyatheaceae
Cyathea_ogurae	Cyatheaceae
Alsophila_salvinii	Cyatheaceae
Cyathea_poolii	Cyatheaceae
Cyathea_andohahelensis	Cyatheaceae
Cyathea_fadenii	Cyatheaceae
Alsophila_capensis	Cyatheaceae
Alsophila_imrayana	Cyatheaceae
Alsophila_cuspidata	Cyatheaceae
Alsophila_firma	Cyatheaceae
Cyathea_tsaratananensis	Cyatheaceae
Cyathea_schliebenii	Cyatheaceae
Cyathea_humilis	Cyatheaceae
Cyathea_perrieriana	Cyatheaceae
Cyathea_marattioides	Cyatheaceae
Cyathea_kirkii	Cyatheaceae
Cyathea_serratifolia	Cyatheaceae
Cyathea_costularis	Cyatheaceae
Cyathea_quadrata	Cyatheaceae
Cyathea_melanocaula	Cyatheaceae
Cyathea_decrescens	Cyatheaceae
Cyathea_approximata	Cyatheaceae
Cyathea_ligulata	Cyatheaceae
Alsophila_acutula	Cyatheaceae
Cyathea_longipinnata	Cyatheaceae
Cyathea_auriculata	Cyatheaceae
Cyathea_grangaudiana	Cyatheaceae
Cyathea_appendiculata	Cyatheaceae
Cyathea_viguieri	Cyatheaceae
Cyathea_borbonica	Cyatheaceae
Cyathea_madagascarica	Cyatheaceae
Cyathea_boivinii	Cyatheaceae
Cyathea_similis	Cyatheaceae
Cyathea_hildebrandtii	Cyatheaceae
Cyathea_concava	Cyatheaceae
Cyathea_melleri	Cyatheaceae
Cyathea_dregei	Cyatheaceae
Cyathea_lastii	Cyatheaceae
Cyathea_excelsa	Cyatheaceae
Cyathea_glauca	Cyatheaceae
Cyathea_manniana	Cyatheaceae
Cyathea_brevipinna	Cyatheaceae
Alsophila_coactilis	Cyatheaceae
Alsophila_foersteri	Cyatheaceae
Alsophila_pachyrrhachis	Cyatheaceae
Alsophila_nigrolineata	Cyatheaceae
Alsophila_smithii	Cyatheaceae
Alsophila_colensoi	Cyatheaceae
Cyathea_cunninghamii	Cyatheaceae
Alsophila_kermadecensis	Cyatheaceae
Cyathea_crinita	Cyatheaceae
Cyathea_nilgirensis	Cyatheaceae
Alsophila_havilandii	Cyatheaceae
Alsophila_oosora	Cyatheaceae
Cyathea_walkerae	Cyatheaceae
Alsophila_hookeri	Cyatheaceae
Cyathea_sinuata	Cyatheaceae
Alsophila_hooglandii	Cyatheaceae
Cyathea_australis	Cyatheaceae
Cyathea_macarthurii	Cyatheaceae
Cyathea_milnei	Cyatheaceae
Alsophila_tricolor	Cyatheaceae
Alsophila_stelligera	Cyatheaceae
Cibotium_arachnoideum	Cibotiaceae
Cibotium_barometz	Cibotiaceae
Cibotium_cumingii	Cibotiaceae
Cibotium_schiedei	Cibotiaceae
Cibotium_regale	Cibotiaceae
Cibotium_glaucum	Cibotiaceae
Cibotium_nealiae	Cibotiaceae
Cibotium_chamissoi	Cibotiaceae
Cibotium_menziesii	Cibotiaceae
Thyrsopteris_elegans	Thyrsopteridaceae
Loxsomopsis_pearcei	Loxsomataceae
Loxsoma_cunninghamii	Loxsomataceae
Culcita_coniifolia	Culcitaceae
Culcita_macrocarpa	Culcitaceae
Plagiogyria_pectinata	Plagiogyriaceae
Plagiogyria_matsumureana	Plagiogyriaceae
Plagiogyria_stenoptera	Plagiogyriaceae
Plagiogyria_egenolfioides	Plagiogyriaceae
Plagiogyria_glauca	Plagiogyriaceae
Plagiogyria_euphlebia	Plagiogyriaceae
Plagiogyria_japonica	Plagiogyriaceae
Plagiogyria_yakumonticola	Plagiogyriaceae
Plagiogyria_koidzumii	Plagiogyriaceae
Diplopterygium_glaucoides	Gleicheniaceae
Diplopterygium_rufum	Gleicheniaceae
Gleichenia_japonica	Gleicheniaceae
Diplopterygium_simulans	Gleicheniaceae
Diplopterygium_chinensis	Gleicheniaceae
Diplopterygium_glaucum	Gleicheniaceae
Diplopterygium_blotianum	Gleicheniaceae
Gleichenia_laevissima	Gleicheniaceae
Diplopterygium_bancroftii	Gleicheniaceae
Gleichenella_pectinata	Gleicheniaceae
Dicranopteris_linearis	Gleicheniaceae
Dicranopteris_flexuosa	Gleicheniaceae
Dicranopteris_gigantea	Gleicheniaceae
Dicranopteris_ampla	Gleicheniaceae
Dicranopteris_pedata	Gleicheniaceae
Dicranopteris_cadetii	Gleicheniaceae
Gleichenia_boryi	Gleicheniaceae
Sticherus_urceolatus	Gleicheniaceae
Sticherus_flabellatus	Gleicheniaceae
Sticherus_flagellaris	Gleicheniaceae
Sticherus_cunninghamii	Gleicheniaceae
Sticherus_tener	Gleicheniaceae
Sticherus_cryptocarpus	Gleicheniaceae
Sticherus_bifidus	Gleicheniaceae
Sticherus_palmatus	Gleicheniaceae
Sticherus_laevigatus	Gleicheniaceae
Gleichenia_polypodioides	Gleicheniaceae
Gleichenia_microphylla	Gleicheniaceae
Gleichenia_dicarpa	Gleicheniaceae
Gleichenia_alpina	Gleicheniaceae
Gleichenia_abscida	Gleicheniaceae
Stromatopteris_moniliformis	Gleicheniaceae
Dipteris_conjugata	Dipteridaceae
Dipteris_lobbiana	Dipteridaceae
Cheiropleuria_parva	Dipteridaceae
Cheiropleuria_integrifolia	Dipteridaceae
Cheiropleuria_bicuspis	Dipteridaceae
Phanerosorus_sarmentosus	Matoniaceae
Phanerosorus_major	Matoniaceae
Matonia_pectinata	Matoniaceae
Matonia_foxworthyi	Matoniaceae
Osmunda_claytoniana	Osmundaceae
Osmunda_hybrida	Osmundaceae
Osmunda_regalis	Osmundaceae
Osmunda_japonica	Osmundaceae
Osmunda_lancea	Osmundaceae
Osmunda_vachellii	Osmundaceae
Osmunda_javanica	Osmundaceae
Osmunda_banksiifolia	Osmundaceae
Osmunda_mildei	Osmundaceae
Osmunda_angustifolia	Osmundaceae
Leptopteris_wilkesiana	Osmundaceae
Leptopteris_superba	Osmundaceae
Leptopteris_hymenophylloides	Osmundaceae
Leptopteris_fraseri	Osmundaceae
Todea_papuana	Osmundaceae
Todea_barbara	Osmundaceae
Osmundastrum_cinnamomeum	Osmundaceae
Ptisana_oreades	Marattiaceae
Ptisana_salicina	Marattiaceae
Ptisana_smithii	Marattiaceae
Marattia_werneri	Marattiaceae
Ptisana_attenuata	Marattiaceae
Ptisana_squamosa	Marattiaceae
Ptisana_pellucida	Marattiaceae
Ptisana_melanesica	Marattiaceae
Ptisana_sambucina	Marattiaceae
Ptisana_howeana	Marattiaceae
Ptisana_sylvatica	Marattiaceae
Ptisana_mertensiana	Marattiaceae
Ptisana_fraxinea	Marattiaceae
Ptisana_salicifolia	Marattiaceae
Ptisana_purpurascens	Marattiaceae
Eupodium_pittieri	Marattiaceae
Eupodium_laeve	Marattiaceae
Eupodium_kaulfussii	Marattiaceae
Marattia_alata	Marattiaceae
Marattia_laxa	Marattiaceae
Marattia_weinmanniifolia	Marattiaceae
Marattia_douglasii	Marattiaceae
Angiopteris_smithii	Marattiaceae
Angiopteris_palmiformis	Marattiaceae
Archangiopteris_henryi	Marattiaceae
Angiopteris_tonkinensis	Marattiaceae
Angiopteris_itoi	Marattiaceae
Angiopteris_somae	Marattiaceae
Angiopteris_bipinnata	Marattiaceae
Angiopteris_hypoleuca	Marattiaceae
Angiopteris_durvilleana	Marattiaceae
Angiopteris_boninensis	Marattiaceae
Angiopteris_evecta	Marattiaceae
Angiopteris_caudatiformis	Marattiaceae
Angiopteris_caudipinna	Marattiaceae
Angiopteris_howii	Marattiaceae
Angiopteris_cartilaginea	Marattiaceae
Angiopteris_omeiensis	Marattiaceae
Angiopteris_hainanensis	Marattiaceae
Angiopteris_madagascariensis	Marattiaceae
Angiopteris_acutidentata	Marattiaceae
Angiopteris_helferiana	Marattiaceae
Angiopteris_wangii	Marattiaceae
Angiopteris_hokouensis	Marattiaceae
Angiopteris_caudata	Marattiaceae
Angiopteris_rapensis	Marattiaceae
Angiopteris_lygodiifolia	Marattiaceae
Angiopteris_fokiensis	Marattiaceae
Angiopteris_angustifolia	Marattiaceae
Christensenia_aesculifolia	Marattiaceae
Danaea_simplicifolia	Marattiaceae
Danaea_antillensis	Marattiaceae
Danaea_trifoliata	Marattiaceae
Danaea_bipinnata	Marattiaceae
Danaea_elliptica	Marattiaceae
Danaea_geniculata	Marattiaceae
Danaea_polymorpha	Marattiaceae
Danaea_arbuscula	Marattiaceae
Danaea_leprieurii	Marattiaceae
Danaea_trichomanoides	Marattiaceae
Danaea_crispa	Marattiaceae
Danaea_carillensis	Marattiaceae
Danaea_urbanii	Marattiaceae
Danaea_jenmanii	Marattiaceae
Danaea_mazeana	Marattiaceae
Danaea_moritziana	Marattiaceae
Danaea_acuminata	Marattiaceae
Danaea_vivax	Marattiaceae
Danaea_falcata	Marattiaceae
Danaea_alata	Marattiaceae
Danaea_wendlandii	Marattiaceae
Danaea_oblanceolata	Marattiaceae
Danaea_nodosa	Marattiaceae
Danaea_cartilaginea	Marattiaceae
Danaea_erecta	Marattiaceae
Danaea_grandifolia	Marattiaceae
Danaea_kalevala	Marattiaceae
Danaea_longicaudata	Marattiaceae
Danaea_media	Marattiaceae
Tmesipteris_tannensis	Psilotaceae
Tmesipteris_obliqua	Psilotaceae
Tmesipteris_elongata	Psilotaceae
Tmesipteris_horomaka	Psilotaceae
Tmesipteris_oblanceolata	Psilotaceae
Tmesipteris_sigmatifolia	Psilotaceae
Tmesipteris_truncata	Psilotaceae
Psilotum_nudum	Psilotaceae
Botrychium_yaaxudakeit	Ophioglossaceae
Botrychium_crenulatum	Ophioglossaceae
Botrychium_tunux	Ophioglossaceae
Botrychium_pallidum	Ophioglossaceae
Botrychium_gallicomontanum	Ophioglossaceae
Botrychium_ascendens	Ophioglossaceae
Botrychium_spathulatum	Ophioglossaceae
Botrychium_campestre	Ophioglossaceae
Botrychium_lineare	Ophioglossaceae
Botrychium_minganense	Ophioglossaceae
Botrychium_watertonense	Ophioglossaceae
Botrychium_mormo	Ophioglossaceae
Botrychium_simplex	Ophioglossaceae
Botrychium_pumicola	Ophioglossaceae
Botrychium_montanum	Ophioglossaceae
Botrychium_lunaria	Ophioglossaceae
Botrychium_echo	Ophioglossaceae
Botrychium_boreale	Ophioglossaceae
Botrychium_acuminatum	Ophioglossaceae
Botrychium_hesperium	Ophioglossaceae
Botrychium_alaskense	Ophioglossaceae
Botrychium_matricariifolium	Ophioglossaceae
Botrychium_lanceolatum	Ophioglossaceae
Botrychium_pinnatum	Ophioglossaceae
Botrychium_pedunculosum	Ophioglossaceae
Sceptridium_schaffneri	Ophioglossaceae
Sceptridium_lunarioides	Ophioglossaceae
Botrychium_ternatum	Ophioglossaceae
Sceptridium_formosanum	Ophioglossaceae
Sceptridium_daucifolium	Ophioglossaceae
Sceptridium_atrovirens	Ophioglossaceae
Sceptridium_japonicum	Ophioglossaceae
Sceptridium_multifidum	Ophioglossaceae
Sceptridium_oneidense	Ophioglossaceae
Sceptridium_dissectum	Ophioglossaceae
Sceptridium_nipponicum	Ophioglossaceae
Sceptridium_triangularifolium	Ophioglossaceae
Botrychium_microphyllum	Ophioglossaceae
Sceptridium_biternatum	Ophioglossaceae
Japanobotrychium_lanuginosum	Ophioglossaceae
Botrychium_chamaeconium	Ophioglossaceae
Botrypus_virginianus	Ophioglossaceae
Botrypus_strictus	Ophioglossaceae
Helminthostachys_zeylanica	Ophioglossaceae
Mankyua_chejuensis	Ophioglossaceae
Ophioglossum_palmatum	Ophioglossaceae
Ophioglossum_falcatum	Ophioglossaceae
Ophioglossum_pendulum	Ophioglossaceae
Ophioglossum_costatum	Ophioglossaceae
Ophioglossum_gomezianum	Ophioglossaceae
Ophioglossum_crotalophoroides	Ophioglossaceae
Ophioglossum_vulgatum	Ophioglossaceae
Ophioglossum_gramineum	Ophioglossaceae
Ophioglossum_coriaceum	Ophioglossaceae
Ophioglossum_reticulatum	Ophioglossaceae
Ophioglossum_petiolatum	Ophioglossaceae
Ophioglossum_richardsiae	Ophioglossaceae
Ophioglossum_namegatae	Ophioglossaceae
Ophioglossum_pusillum	Ophioglossaceae
Ophioglossum_parvum	Ophioglossaceae
Ophioglossum_kawamurae	Ophioglossaceae
Ophioglossum_nudicaule	Ophioglossaceae
Ophioglossum_engelmannii	Ophioglossaceae
Equisetum_palustre	Equisetaceae
Equisetum_sylvaticum	Equisetaceae
Equisetum_arvense	Equisetaceae
Equisetum_fluviatile	Equisetaceae
Equisetum_diffusum	Equisetaceae
Equisetum_pratense	Equisetaceae
Equisetum_myriochaetum	Equisetaceae
Equisetum_laevigatum	Equisetaceae
Equisetum_hyemale	Equisetaceae
Equisetum_ramosissimum	Equisetaceae
Equisetum_giganteum	Equisetaceae
Equisetum_variegatum	Equisetaceae
Equisetum_scirpoides	Equisetaceae
Equisetum_telmateia	Equisetaceae
Equisetum_bogotense	Equisetaceae