species	family
tachyglossus_aculeatus	Tachyglossidae
zaglossus_bruijni	Tachyglossidae
ornithorhynchus_anatinus	Ornithorhynchidae
isoodon_obesulus_affinis	Peramelidae
isoodon_auratus_barrowensis	Peramelidae
isoodon_macrourus_moresbyensis	Peramelidae
perameles_bougainville_notina	Peramelidae
perameles_eremiana	Peramelidae
perameles_nasuta	Peramelidae
perameles_gunnii	Peramelidae
echymipera_kalubu	Peroryctidae
echymipera_rufescens_australis	Peroryctidae
rhynchomeles_prattorum	Peroryctidae
echymipera_clara	Peroryctidae
microperoryctes_longicauda_magnus	Peroryctidae
microperoryctes_papuensis	Peroryctidae
microperoryctes_aplini	Peroryctidae
peroryctes_broadbenti	Peroryctidae
peroryctes_raffrayana	Peroryctidae
macrotis_lagotis	Peramelidae
myoictis_melas	Dasyuridae
myoictis_wavicus	Dasyuridae
myoictis_leucura	Dasyuridae
myoictis_wallacei	Dasyuridae
parantechinus_apicalis	Dasyuridae
dasykaluta_rosamondae	Dasyuridae
dasycercus_cristicauda	Dasyuridae
dasyuroides_byrnei	Dasyuridae
pseudantechinus_macdonnellensis	Dasyuridae
pseudantechinus_roryi	Dasyuridae
pseudantechinus_mimulus	Dasyuridae
pseudantechinus_ningbing	Dasyuridae
pseudantechinus_woolleyae	Dasyuridae
pseudantechinus_bilarni	Dasyuridae
dasyurus_spartacus	Dasyuridae
dasyurus_geoffroii	Dasyuridae
dasyurus_albopunctatus	Dasyuridae
dasyurus_viverrinus	Dasyuridae
dasyurus_maculatus	Dasyuridae
dasyurus_hallucatus	Dasyuridae
dasyuridae_sp_jmz_2005	Dasyuridae
sarcophilus_harrisii	Dasyuridae
phascolosorex_dorsalis	Dasyuridae
neophascogale_lorentzii	Dasyuridae
antechinus_flavipes	Dasyuridae
antechinus_bellus	Dasyuridae
antechinus_leo	Dasyuridae
antechinus_agilis	Dasyuridae
antechinus_stuartii	Dasyuridae
antechinus_godmani	Dasyuridae
antechinus_swainsonii	Dasyuridae
antechinus_minimus	Dasyuridae
murexia_longicaudata_aspera	Dasyuridae
murexia_naso	Dasyuridae
murexchinus_melanurus	Dasyuridae
micromurexia_habbema	Dasyuridae
paramurexia_rothschildi	Dasyuridae
phascogale_tapoatafa	Dasyuridae
phascogale_calura	Dasyuridae
sminthopsis_murina_tatei	Dasyuridae
sminthopsis_gilberti	Dasyuridae
sminthopsis_butleri	Dasyuridae
sminthopsis_dolichura	Dasyuridae
sminthopsis_leucopus_leucopus	Dasyuridae
sminthopsis_archeri	Dasyuridae
sminthopsis_hirtipes	Dasyuridae
sminthopsis_psammophila	Dasyuridae
sminthopsis_youngsoni	Dasyuridae
sminthopsis_ooldea	Dasyuridae
sminthopsis_granulipes	Dasyuridae
sminthopsis_aitkeni	Dasyuridae
sminthopsis_griseoventer	Dasyuridae
sminthopsis_longicaudata	Dasyuridae
antechinomys_laniger	Dasyuridae
ningaui_ridei	Dasyuridae
ningaui_yvonnae	Dasyuridae
ningaui_timealeyi	Dasyuridae
sminthopsis_virginiae	Dasyuridae
sminthopsis_douglasi	Dasyuridae
sminthopsis_stalkeri	Dasyuridae
sminthopsis_froggatti	Dasyuridae
sminthopsis_macroura	Dasyuridae
sminthopsis_bindi	Dasyuridae
sminthopsis_crassicaudata	Dasyuridae
planigale_maculata	Dasyuridae
planigale_novaeguineae	Dasyuridae
planigale_ingrami	Dasyuridae
planigale_tenuirostris	Dasyuridae
planigale_gilesi	Dasyuridae
myrmecobius_fasciatus	Myrmecobiidae
notoryctes_typhlops	Notoryctidae
notoryctes_caurinus	Notoryctidae
petrogale_inornata	Macropodidae
petrogale_mareeba	Macropodidae
petrogale_assimilis	Macropodidae
petrogale_herberti	Macropodidae
petrogale_penicillata	Macropodidae
petrogale_purpureicollis	Macropodidae
petrogale_lateralis	Macropodidae
petrogale_rothschildi	Macropodidae
petrogale_xanthopus	Macropodidae
petrogale_brachyotis_victoriae	Macropodidae
petrogale_concinna	Macropodidae
petrogale_burbidgei	Macropodidae
petrogale_persephone	Macropodidae
dendrolagus_goodfellowi	Macropodidae
dendrolagus_dorianus	Macropodidae
dendrolagus_matschiei	Macropodidae
dendrolagus_lumholtzi	Macropodidae
thylogale_stigmatica_wilcoxi	Macropodidae
thylogale_brunii	Macropodidae
thylogale_browni	Macropodidae
thylogale_calabyi	Macropodidae
thylogale_thetis	Macropodidae
thylogale_billardierii	Macropodidae
macropus_rufogriseus_banksianus	Macropodidae
macropus_parma	Macropodidae
macropus_parryi	Macropodidae
macropus_agilis	Macropodidae
macropus_dorsalis	Macropodidae
macropus_antilopinus	Macropodidae
macropus_robustus	Macropodidae
macropus_irma	Macropodidae
macropus_rufus	Macropodidae
macropus_giganteus	Macropodidae
macropus_fuliginosus	Macropodidae
macropus_eugenii	Macropodidae
wallabia_bicolor	Macropodidae
lagorchestes_conspicillatus	Macropodidae
lagorchestes_hirsutus	Macropodidae
onychogalea_fraenata	Macropodidae
onychogalea_unguifera	Macropodidae
setonix_brachyurus	Macropodidae
dorcopsulus_vanheurni	Macropodidae
dorcopsis_veterum	Macropodidae
dorcopsis_hageni	Macropodidae
lagostrophus_fasciatus	Macropodidae
bettongia_penicillata_ogilbyi	Potoroidae
bettongia_tropica	Potoroidae
bettongia_gaimardi	Potoroidae
bettongia_lesueur	Potoroidae
aepyprymnus_rufescens	Potoroidae
potorous_tridactylus	Potoroidae
potorous_gilbertii	Potoroidae
potorous_longipes	Potoroidae
hypsiprymnodon_moschatus	Potoroidae
pseudochirops_albertisii	Pseudocheiridae
pseudochirops_cupreus	Pseudocheiridae
pseudochirops_corinnae	Pseudocheiridae
pseudochirops_archeri	Pseudocheiridae
petropseudes_dahli	Pseudocheiridae
hemibelideus_lemuroides	Pseudocheiridae
petauroides_volans	Pseudocheiridae
pseudochirulus_forbesi	Pseudocheiridae
pseudochirulus_canescens	Pseudocheiridae
pseudochirulus_caroli	Pseudocheiridae
pseudochirulus_mayeri	Pseudocheiridae
pseudochirulus_herbertensis	Pseudocheiridae
pseudocheirus_peregrinus	Pseudocheiridae
petaurus_breviceps	Petauridae
petaurus_norfolcensis	Petauridae
petaurus_abidi	Petauridae
gymnobelideus_leadbeateri	Petauridae
dactylopsila_trivirgata	Petauridae
dactylopsila_palpator	Petauridae
tarsipes_rostratus	Tarsipedidae
distoechurus_pennatus	Acrobatidae
acrobates_pygmaeus	Acrobatidae
phalanger_orientalis	Phalangeridae
phalanger_carmelitae	Phalangeridae
phalanger_sericeus	Phalangeridae
phalanger_lullulae	Phalangeridae
phalanger_vestitus	Phalangeridae
phalanger_gymnotis	Phalangeridae
spilocuscus_rufoniger	Phalangeridae
spilocuscus_maculatus	Phalangeridae
strigocuscus_pelengensis	Phalangeridae
strigocuscus_celebensis	Phalangeridae
ailurops_ursinus	Phalangeridae
trichosurus_arnhemensis	Phalangeridae
trichosurus_vulpecula	Phalangeridae
trichosurus_caninus	Phalangeridae
trichosurus_johnstonii	Phalangeridae
wyulda_squamicaudata	Phalangeridae
cercartetus_concinnus	Burramyidae
cercartetus_nanus	Burramyidae
cercartetus_lepidus	Burramyidae
cercartetus_caudatus_macrurus	Burramyidae
burramys_parvus	Burramyidae
lasiorhinus_latifrons	Vombatidae
vombatus_ursinus	Vombatidae
lasiorhinus_krefftii	Vombatidae
phascolarctos_cinereus	Phascolarctidae
dromiciops_gliroides	Microbiotheriidae
monodelphis_osgoodi	Didelphidae
monodelphis_handleyi	Didelphidae
monodelphis_peruviana	Didelphidae
monodelphis_adusta	Didelphidae
monodelphis_reigi	Didelphidae
monodelphis_kunsi	Didelphidae
monodelphis_emiliae	Didelphidae
monodelphis_umbristriata	Didelphidae
monodelphis_americana	Didelphidae
monodelphis_iheringi	Didelphidae
monodelphis_gardneri	Didelphidae
monodelphis_scalops	Didelphidae
monodelphis_theresa	Didelphidae
monodelphis_dimidiata	Didelphidae
monodelphis_brevicaudata	Didelphidae
monodelphis_palliolata	Didelphidae
monodelphis_touan	Didelphidae
monodelphis_arlindoi	Didelphidae
monodelphis_glirina	Didelphidae
monodelphis_sanctaerosae	Didelphidae
monodelphis_domestica	Didelphidae
marmosa_micoureus_paraguayana	Didelphidae
marmosa_murina	Didelphidae
marmosa_macrotarsus	Didelphidae
marmosa_waterhousei	Didelphidae
marmosa_tyleriana	Didelphidae
marmosa_lepida	Didelphidae
marmosa_robinsoni	Didelphidae
marmosa_xerophila	Didelphidae
marmosa_isthmica	Didelphidae
marmosa_mexicana_zeledoni	Didelphidae
marmosa_simonsi	Didelphidae
marmosa_rubra	Didelphidae
tlacuatzin_canescens	Didelphidae
thylamys_elegans	Didelphidae
thylamys_pallidior	Didelphidae
thylamys_tatei	Didelphidae
thylamys_pusillus	Didelphidae
thylamys_pulchellus	Didelphidae
thylamys_venustus	Didelphidae
thylamys_sponsorius	Didelphidae
thylamys_macrura	Didelphidae
thylamys_karimii	Didelphidae
thylamys_velutinus	Didelphidae
lestodelphys_halli	Didelphidae
cryptonanus_chacoensis	Didelphidae
cryptonanus_unduaviensis	Didelphidae
cryptonanus_agricolai	Didelphidae
gracilinanus_aceramarcae	Didelphidae
gracilinanus_microtarsus	Didelphidae
gracilinanus_agilis	Didelphidae
gracilinanus_emiliae	Didelphidae
marmosops_dorothea	Didelphidae
marmosops_impavidus	Didelphidae
marmosops_noctivagus	Didelphidae
marmosops_paulensis	Didelphidae
marmosops_incanus	Didelphidae
marmosops_pakaraimae	Didelphidae
marmosops_parvidens	Didelphidae
marmosops_pinheiroi	Didelphidae
metachirus_nudicaudatus	Didelphidae
didelphis_marsupialis	Didelphidae
didelphis_albiventris	Didelphidae
didelphis_virginiana	Didelphidae
philander_frenatus	Didelphidae
philander_opossum	Didelphidae
philander_mcilhennyi	Didelphidae
lutreolina_crassicaudata	Didelphidae
chironectes_minimus	Didelphidae
hyladelphys_kalinowskii	Didelphidae
glironia_venusta	Didelphidae
caluromys_derbianus	Didelphidae
caluromys_lanatus	Didelphidae
caluromys_philander	Didelphidae
caluromysiops_irrupta	Didelphidae
caenolestes_caniventer	Caenolestidae
caenolestes_sangay	Caenolestidae
caenolestes_fuliginosus	Caenolestidae
rhyncholestes_raphanurus	Caenolestidae
lestoros_inca	Caenolestidae
cabassous_centralis	Chlamyphoridae
cabassous_unicinctus	Chlamyphoridae
cabassous_chacoensis	Chlamyphoridae
cabassous_tatouay	Chlamyphoridae
tolypeutes_tricinctus	Chlamyphoridae
tolypeutes_matacus	Chlamyphoridae
priodontes_maximus	Chlamyphoridae
calyptophractus_retusus	Chlamyphoridae
chlamyphorus_truncatus	Chlamyphoridae
chaetophractus_vellerosus	Chlamyphoridae
zaedyus_pichiy	Chlamyphoridae
chaetophractus_villosus	Chlamyphoridae
euphractus_sexcinctus	Chlamyphoridae
dasypus_sabanicola	Dasypodidae
dasypus_yepesi	Dasypodidae
dasypus_pilosus	Dasypodidae
dasypus_hybridus	Dasypodidae
dasypus_septemcinctus	Dasypodidae
dasypus_novemcinctus	Dasypodidae
dasypus_kappleri	Dasypodidae
bradypus_variegatus	Bradypodidae
bradypus_tridactylus	Bradypodidae
bradypus_pygmaeus	Bradypodidae
bradypus_torquatus	Bradypodidae
choloepus_hoffmanni	Megalonychidae
choloepus_didactylus	Megalonychidae
tamandua_tetradactyla	Myrmecophagidae
tamandua_mexicana	Myrmecophagidae
myrmecophaga_tridactyla	Myrmecophagidae
cyclopes_didactylus	Cyclopedidae
amblysomus_hottentotus	Chrysochloridae
amblysomus_corriae	Chrysochloridae
amblysomus_marleyi	Chrysochloridae
amblysomus_septentrionalis	Chrysochloridae
amblysomus_robustus	Chrysochloridae
neamblysomus_gunningi	Chrysochloridae
neamblysomus_julianae	Chrysochloridae
carpitalpa_arendsi	Chrysochloridae
chrysospalax_trevelyani	Chrysochloridae
calcochloris_obtusirostris	Chrysochloridae
chrysospalax_villosus	Chrysochloridae
chlorotalpa_sclateri	Chrysochloridae
chlorotalpa_duthieae	Chrysochloridae
eremitalpa_granti	Chrysochloridae
cryptochloris_wintoni	Chrysochloridae
chrysochloris_asiatica	Chrysochloridae
chrysochloris_stuhlmanni	Chrysochloridae
microgale_majori	Tenrecidae
microgale_longicaudata	Tenrecidae
microgale_principula	Tenrecidae
microgale_pusilla	Tenrecidae
limnogale_mergulus	Tenrecidae
microgale_brevicaudata	Tenrecidae
microgale_talazaci	Tenrecidae
geogale_aurita	Tenrecidae
oryzorictes	Tenrecidae
tenrec_ecaudatus	Tenrecidae
hemicentetes_semispinosus	Tenrecidae
setifer_setosus	Tenrecidae
echinops_telfairi	Tenrecidae
potamogale_velox	Tenrecidae
micropotamogale_lamottei	Tenrecidae
elephantulus_brachyrhynchus	Macroscelididae
elephantulus_rufescens	Macroscelididae
elephantulus_rupestris	Macroscelididae
elephantulus_intufi	Macroscelididae
elephantulus_myurus	Macroscelididae
elephantulus_sp_vb001	Macroscelididae
elephantulus_edwardii	Macroscelididae
macroscelides_flavicaudatus	Macroscelididae
macroscelides_proboscideus	Macroscelididae
macroscelides_micus	Macroscelididae
petrosaltator_rozeti	Macroscelididae
petrodromus_tetradactylus	Macroscelididae
rhynchocyon_petersi	Macroscelididae
rhynchocyon_cirnei_reichardi	Macroscelididae
rhynchocyon_udzungwensis	Macroscelididae
orycteropus_afer	Orycteropodidae
loxodonta_africana	Elephantidae
loxodonta_cyclotis	Elephantidae
elephas_maximus	Elephantidae
trichechus_manatus	Trichechidae
dugong_dugon	Dugongidae
heterohyrax_brucei	Procaviidae
procavia_capensis	Procaviidae
dendrohyrax_dorsalis	Procaviidae
aonyx_cinerea	Mustelidae
lutrogale_perspicillata	Mustelidae
aonyx_capensis	Mustelidae
lutra_lutra	Mustelidae
lutra_sumatrana	Mustelidae
hydrictis_maculicollis	Mustelidae
enhydra_lutris	Mustelidae
lontra_provocax	Mustelidae
lontra_felina	Mustelidae
lontra_longicaudis	Mustelidae
lontra_canadensis	Mustelidae
lyncodon_patagonicus	Mustelidae
galictis_vittata	Mustelidae
galictis_cuja	Mustelidae
pteronura_brasiliensis	Mustelidae
poecilogale_albinucha	Mustelidae
ictonyx_striatus	Mustelidae
ictonyx_libyca	Mustelidae
vormela_peregusna	Mustelidae
mustela_putorius	Mustelidae
mustela_lutreola	Mustelidae
mustela_eversmannii	Mustelidae
mustela_nigripes	Mustelidae
mustela_sibirica	Mustelidae
mustela_itatsi	Mustelidae
mustela_altaica	Mustelidae
mustela_nivalis	Mustelidae
mustela_erminea	Mustelidae
mustela_strigidorsa	Mustelidae
mustela_nudipes	Mustelidae
mustela_kathiah	Mustelidae
mustela_africana	Mustelidae
mustela_frenata	Mustelidae
mustela_felipei	Mustelidae
neovison_vison	Mustelidae
melogale_moschata_subaurantiaca	Mustelidae
melogale_personata	Mustelidae
martes_melampus_tsuensis	Mustelidae
martes_zibellina	Mustelidae
martes_martes	Mustelidae
martes_americana_caurina	Mustelidae
martes_foina	Mustelidae
martes_flavigula	Mustelidae
gulo_gulo	Mustelidae
eira_barbara	Mustelidae
pekania_pennanti	Mustelidae
meles_canescens	Mustelidae
meles_meles_arcalus	Mustelidae
meles_anakuma	Mustelidae
meles_leucurus	Mustelidae
arctonyx_collaris	Mustelidae
mellivora_capensis	Mustelidae
taxidea_taxus	Mustelidae
bassaricyon_gabbii	Procyonidae
bassaricyon_medius_medius	Procyonidae
bassaricyon_alleni	Procyonidae
bassaricyon_neblina_neblina	Procyonidae
nasua_narica	Procyonidae
nasuella_olivacea	Procyonidae
nasua_nasua	Procyonidae
procyon_lotor	Procyonidae
procyon_cancrivorus	Procyonidae
bassariscus_sumichrasti	Procyonidae
bassariscus_astutus	Procyonidae
potos_flavus	Procyonidae
mephitis_mephitis	Mephitidae
spilogale	Mephitidae
conepatus	Mephitidae
mydaus	Mephitidae
ailurus_fulgens	Ailuridae
phoca_vitulina_stejnegeri	Phocidae
phoca_largha	Phocidae
pusa_hispida	Phocidae
pusa_sibirica	Phocidae
pusa_caspica	Phocidae
halichoerus_grypus	Phocidae
phoca_groenlandica	Phocidae
phoca_fasciata	Phocidae
cystophora_cristata	Phocidae
erignathus_barbatus	Phocidae
hydrurga_leptonyx	Phocidae
leptonychotes_weddellii	Phocidae
lobodon_carcinophaga	Phocidae
ommatophoca_rossii	Phocidae
mirounga_leonina	Phocidae
mirounga_angustirostris	Phocidae
monachus_monachus	Phocidae
monachus_schauinslandi	Phocidae
arctocephalus_australis	Otariidae
arctocephalus_forsteri	Otariidae
arctocephalus_gazella	Otariidae
arctocephalus_townsendi	Otariidae
phocarctos_hookeri	Otariidae
neophoca_cinerea	Otariidae
arctocephalus_pusillus	Otariidae
otaria_byronia	Otariidae
arctocephalus_tropicalis	Otariidae
zalophus_californianus	Otariidae
eumetopias_jubatus	Otariidae
callorhinus_ursinus	Otariidae
odobenus_rosmarus_divergens	Odobenidae
ursus_thibetanus_mupinensis	Ursidae
ursus_americanus	Ursidae
helarctos_malayanus	Ursidae
ursus_maritimus	Ursidae
ursus_arctos	Ursidae
melursus_ursinus	Ursidae
tremarctos_ornatus	Ursidae
ailuropoda_melanoleuca	Ursidae
canis_lupus_dingo	Canidae
canis_familiaris	Canidae
canis_indica	Canidae
canis_himalayensis	Canidae
canis_anthus	Canidae
canis_lupaster	Canidae
canis_aureus	Canidae
canis_latrans	Canidae
canis_simensis	Canidae
lupulella_mesomelas_elongae	Canidae
cuon_alpinus_lepturus	Canidae
canis_rufus	Canidae
lupulella_adusta	Canidae
lycaon_pictus	Canidae
lycalopex_fulvipes	Canidae
lycalopex_vetulus	Canidae
lycalopex_griseus	Canidae
lycalopex_culpaeus	Canidae
lycalopex_gymnocercus	Canidae
lycalopex_sechurae	Canidae
atelocynus_microtis	Canidae
cerdocyon_thous	Canidae
dusicyon_australis	Canidae
dusicyon_avus	Canidae
chrysocyon_brachyurus	Canidae
speothos_venaticus	Canidae
vulpes_cana	Canidae
vulpes_zerda	Canidae
vulpes_chama	Canidae
vulpes_vulpes	Canidae
vulpes_rueppellii	Canidae
vulpes_velox	Canidae
vulpes_corsac	Canidae
vulpes_ferrilata	Canidae
vulpes_lagopus	Canidae
vulpes_macrotis	Canidae
nyctereutes_procyonoides	Canidae
otocyon_megalotis	Canidae
urocyon_littoralis_santarosae	Canidae
urocyon_cinereoargenteus	Canidae
bdeogale_nigripes	Herpestidae
bdeogale_crassicauda	Herpestidae
cynictis_penicillata	Herpestidae
paracynictis_selousi	Herpestidae
rhynchogale_melleri	Herpestidae
ichneumia_albicauda	Herpestidae
galerella_nigrata	Herpestidae
galerella_sanguinea	Herpestidae
galerella_pulverulenta	Herpestidae
herpestes_ichneumon	Herpestidae
herpestes_auropunctatus	Herpestidae
herpestes_javanicus	Herpestidae
herpestes_edwardsii	Herpestidae
herpestes_fuscus	Herpestidae
herpestes_urva	Herpestidae
herpestes_brachyurus	Herpestidae
herpestes_naso	Herpestidae
atilax_paludinosus	Herpestidae
crossarchus_obscurus	Herpestidae
crossarchus_alexandri	Herpestidae
crossarchus_platycephalus	Herpestidae
helogale_hirtula	Herpestidae
helogale_parvula	Herpestidae
liberiictis_kuhni	Herpestidae
mungos_mungo	Herpestidae
suricata_suricatta	Herpestidae
salanoia_concolor	Eupleridae
mungotictis_decemlineata	Eupleridae
galidictis_fasciata	Eupleridae
galidia_elegans	Eupleridae
cryptoprocta_ferox	Eupleridae
eupleres_goudotii	Eupleridae
fossa_fossana	Eupleridae
parahyaena_brunnea	Hyaenidae
hyaena_hyaena	Hyaenidae
proteles_cristatus	Hyaenidae
crocuta_crocuta	Hyaenidae
genetta_bourloni	Viverridae
genetta_poensis	Viverridae
genetta_maculata	Viverridae
genetta_pardina	Viverridae
genetta_angolensis	Viverridae
genetta_tigrina	Viverridae
genetta_genetta	Viverridae
osbornictis_piscivora	Viverridae
genetta_johnstoni	Viverridae
genetta_cristata	Viverridae
genetta_servalina	Viverridae
genetta_thierryi	Viverridae
genetta_victoriae	Viverridae
poiana_richardsonii	Viverridae
viverra_megaspila	Viverridae
viverra_zibetha	Viverridae
viverra_tangalunga	Viverridae
civettictis_civetta	Viverridae
viverricula_indica	Viverridae
paradoxurus_jerdoni	Viverridae
paradoxurus_zeylonensis	Viverridae
paradoxurus_hermaphroditus	Viverridae
arctictis_binturong	Viverridae
paguma_larvata	Viverridae
arctogalidia_trivirgata	Viverridae
chrotogale_owstoni	Viverridae
hemigalus_derbyanus	Viverridae
cynogale_bennettii	Viverridae
macrogalidia_musschenbroekii	Viverridae
felis_silvestris_bieti	Felidae
felis_catus	Felidae
felis_margarita	Felidae
felis_chaus	Felidae
felis_nigripes	Felidae
prionailurus_bengalensis	Felidae
prionailurus_iriomotensis	Felidae
prionailurus_viverrinus	Felidae
prionailurus_planiceps	Felidae
prionailurus_rubiginosus	Felidae
otocolobus_manul	Felidae
lynx_pardinus	Felidae
lynx_canadensis	Felidae
lynx_lynx	Felidae
lynx_rufus	Felidae
puma_concolor_couguar	Felidae
puma_yagouaroundi	Felidae
acinonyx_jubatus	Felidae
catopuma_temminckii	Felidae
catopuma_badia	Felidae
pardofelis_marmorata	Felidae
profelis_aurata	Felidae
caracal_caracal	Felidae
leptailurus_serval	Felidae
leopardus_pardalis	Felidae
leopardus_wiedii	Felidae
leopardus_colocolo	Felidae
leopardus_jacobita	Felidae
leopardus_geoffroyi	Felidae
leopardus_guigna	Felidae
leopardus_tigrinus	Felidae
panthera_pardus_orientalis	Felidae
panthera_leo_persica	Felidae
panthera_uncia	Felidae
panthera_onca	Felidae
panthera_tigris_sumatrae	Felidae
neofelis_nebulosa	Felidae
prionodon_linsang	Viverridae
prionodon_pardicolor	Viverridae
nandinia_binotata	Nandiniidae
equus_burchellii	Equidae
equus_grevyi	Equidae
equus_zebra	Equidae
equus_hemionus	Equidae
equus_kiang	Equidae
equus_asinus_africanus	Equidae
equus_przewalskii	Equidae
equus_caballus	Equidae
diceros_bicornis	Rhinocerotidae
ceratotherium_simum_cottoni	Rhinocerotidae
rhinoceros_sondaicus_annamiticus	Rhinocerotidae
rhinoceros_unicornis	Rhinocerotidae
dicerorhinus_sumatrensis_harrissoni	Rhinocerotidae
tapirus_terrestris	Tapiridae
tapirus_pinchaque	Tapiridae
tapirus_kabomani	Tapiridae
tapirus_bairdii	Tapiridae
tapirus_indicus	Tapiridae
capra_falconeri	Bovidae
capra_aegagrus_blythi	Bovidae
capra_caucasica	Bovidae
capra_cylindricornis	Bovidae
capra_hircus	Bovidae
capra_pyrenaica_hispanica	Bovidae
capra_ibex	Bovidae
capra_nubiana	Bovidae
capra_sibirica	Bovidae
hemitragus_jemlahicus	Bovidae
pseudois_schaeferi	Bovidae
pseudois_nayaur_szechuanensis	Bovidae
rupicapra_rupicapra_carpatica	Bovidae
rupicapra_pyrenaica_parva	Bovidae
budorcas_taxicolor	Bovidae
oreamnos_americanus	Bovidae
arabitragus_jayakari	Bovidae
ammotragus_lervia	Bovidae
ovis_orientalis_anatolica	Bovidae
ovis_ammon_collium	Bovidae
ovis_aries_musimon	Bovidae
ovis_vignei_blanfordi	Bovidae
ovis_canadensis_mexicana	Bovidae
ovis_dalli	Bovidae
ovis_nivicola	Bovidae
nilgiritragus_hylocrius	Bovidae
capricornis_thar_jamrachi	Bovidae
capricornis_milneedwardsii	Bovidae
capricornis_sumatraensis	Bovidae
capricornis_swinhoei	Bovidae
capricornis_crispus	Bovidae
naemorhedus_caudatus_raddeanus	Bovidae
naemorhedus_goral	Bovidae
naemorhedus_baileyi	Bovidae
naemorhedus_griseus	Bovidae
ovibos_moschatus	Bovidae
pantholops_hodgsonii	Bovidae
oryx_beisa	Bovidae
oryx_leucoryx	Bovidae
oryx_gazella	Bovidae
oryx_dammah	Bovidae
addax_nasomaculatus	Bovidae
hippotragus_niger	Bovidae
hippotragus_equinus	Bovidae
damaliscus_lunatus	Bovidae
damaliscus_pygargus	Bovidae
beatragus_hunteri	Bovidae
alcelaphus_lichtensteini	Bovidae
alcelaphus_buselaphus	Bovidae
connochaetes_taurinus	Bovidae
connochaetes_gnou	Bovidae
gazella_erlangeri	Bovidae
gazella_arabica	Bovidae
gazella_gazella	Bovidae
gazella_dorcas_pelzelnii	Bovidae
gazella_spekei	Bovidae
gazella_cuvieri	Bovidae
gazella_leptoceros	Bovidae
gazella_marica	Bovidae
gazella_subgutturosa	Bovidae
gazella_saudiya	Bovidae
gazella_bennettii	Bovidae
nanger_dama_mhorr	Bovidae
nanger_soemmerringii	Bovidae
nanger_granti	Bovidae
eudorcas_rufifrons	Bovidae
eudorcas_thomsonii	Bovidae
antilope_cervicapra	Bovidae
antidorcas_marsupialis	Bovidae
litocranius_walleri	Bovidae
saiga_tatarica	Bovidae
ourebia_ourebi	Bovidae
madoqua_guentheri	Bovidae
madoqua_kirkii	Bovidae
madoqua_saltiana	Bovidae
dorcatragus_megalotis	Bovidae
raphicerus_sharpei	Bovidae
raphicerus_campestris	Bovidae
raphicerus_melanotis	Bovidae
procapra_gutturosa	Bovidae
procapra_przewalskii	Bovidae
procapra_picticaudata	Bovidae
kobus_leche_kafuensis	Bovidae
kobus_megaceros	Bovidae
kobus_kob	Bovidae
kobus_vardonii	Bovidae
kobus_ellipsiprymnus_defassa	Bovidae
redunca_redunca	Bovidae
redunca_arundinum	Bovidae
redunca_fulvorufula	Bovidae
pelea_capreolus	Bovidae
cephalophus_natalensis	Bovidae
cephalophus_harveyi	Bovidae
cephalophus_nigrifrons	Bovidae
cephalophus_rufilatus	Bovidae
cephalophus_leucogaster	Bovidae
cephalophus_weynsi	Bovidae
cephalophus_callipygus	Bovidae
cephalophus_ogilbyi	Bovidae
cephalophus_niger	Bovidae
cephalophus_rubidus	Bovidae
cephalophus_spadix	Bovidae
cephalophus_silvicultor	Bovidae
cephalophus_jentinki	Bovidae
cephalophus_dorsalis	Bovidae
sylvicapra_grimmia	Bovidae
cephalophus_adersi	Bovidae
cephalophus_zebra	Bovidae
philantomba_maxwellii	Bovidae
philantomba_monticola	Bovidae
neotragus_pygmaeus	Bovidae
oreotragus_oreotragus	Bovidae
neotragus_moschatus_livingstonianus	Bovidae
neotragus_batesi	Bovidae
aepyceros_melampus	Bovidae
bos_mutus	Bovidae
bos_grunniens	Bovidae
bos_bison	Bovidae
bos_gaurus	Bovidae
bos_javanicus_lowi	Bovidae
bos_sauveli	Bovidae
bos_taurus	Bovidae
bos_primigenius	Bovidae
bos_indicus	Bovidae
bos_frontalis	Bovidae
bos_bonasus	Bovidae
pseudoryx_nghetinhensis	Bovidae
bubalus_quarlesi	Bovidae
bubalus_depressicornis	Bovidae
bubalus_mindorensis	Bovidae
bubalus_bubalis	Bovidae
bubalus_carabanensis	Bovidae
syncerus_caffer	Bovidae
tragelaphus_eurycerus	Bovidae
tragelaphus_spekii	Bovidae
tragelaphus_scriptus	Bovidae
tragelaphus_buxtoni	Bovidae
tragelaphus_oryx	Bovidae
tragelaphus_derbianus	Bovidae
tragelaphus_strepsiceros	Bovidae
tragelaphus_angasii	Bovidae
tragelaphus_imberbis	Bovidae
boselaphus_tragocamelus	Bovidae
tetracerus_quadricornis	Bovidae
cervus_elaphus_kansuensis	Cervidae
cervus_canadensis_songaricus	Cervidae
cervus_nippon_mantchuricus	Cervidae
cervus_unicolor_cambojensis	Cervidae
cervus_albirostris	Cervidae
cervus_timorensis_macassaricus	Cervidae
cervus_alfredi	Cervidae
rucervus_eldii_thamin	Cervidae
elaphurus_davidianus	Cervidae
dama_dama	Cervidae
dama_mesopotamica	Cervidae
rucervus_schomburgki	Cervidae
rucervus_duvaucelii	Cervidae
axis_axis	Cervidae
axis_porcinus	Cervidae
muntiacus_muntjak_nigripes	Cervidae
muntiacus_gongshanensis	Cervidae
muntiacus_crinifrons	Cervidae
muntiacus_feae	Cervidae
muntiacus_putaoensis	Cervidae
muntiacus_truongsonensis	Cervidae
muntiacus_rooseveltorum	Cervidae
muntiacus_vuquangensis	Cervidae
muntiacus_reevesi_micrurus	Cervidae
elaphodus_cephalophus	Cervidae
odocoileus_hemionus_californicus	Cervidae
odocoileus_virginianus	Cervidae
mazama_temama	Cervidae
mazama_americana	Cervidae
mazama_pandora	Cervidae
mazama_rufina	Cervidae
pudu_mephistophiles	Cervidae
hippocamelus_bisulcus	Cervidae
hippocamelus_antisensis	Cervidae
mazama_gouazoupira	Cervidae
ozotoceros_bezoarticus	Cervidae
mazama_nemorivaga	Cervidae
blastocerus_dichotomus	Cervidae
pudu_puda	Cervidae
rangifer_tarandus	Cervidae
capreolus_pygargus_tianschanicus	Cervidae
capreolus_capreolus	Cervidae
hydropotes_inermis_argyropus	Cervidae
alces_alces	Cervidae
moschus_berezovskii_caobangis	Moschidae
moschus_leucogaster	Moschidae
moschus_fuscus	Moschidae
moschus_anhuiensis	Moschidae
moschus_chrysogaster	Moschidae
moschus_moschiferus	Moschidae
giraffa_camelopardalis_antiquorum	Giraffidae
okapia_johnstoni	Giraffidae
antilocapra_americana_sonoriensis	Antilocapridae
tragulus_kanchil	Tragulidae
tragulus_javanicus	Tragulidae
tragulus_napu	Tragulidae
moschiola_meminna	Tragulidae
hyemoschus_aquaticus	Tragulidae
cephalorhynchus_hectori_maui	Delphinidae
cephalorhynchus_commersonii	Delphinidae
cephalorhynchus_eutropia	Delphinidae
cephalorhynchus_heavisidii	Delphinidae
lagenorhynchus_australis	Delphinidae
lagenorhynchus_cruciger	Delphinidae
lagenorhynchus_obliquidens	Delphinidae
lagenorhynchus_obscurus	Delphinidae
lissodelphis_peronii	Delphinidae
lissodelphis_borealis	Delphinidae
orcinus_orca	Delphinidae
globicephala_macrorhynchus	Delphinidae
globicephala_melas	Delphinidae
feresa_attenuata	Delphinidae
peponocephala_electra	Delphinidae
pseudorca_crassidens	Delphinidae
grampus_griseus	Delphinidae
orcaella_brevirostris	Delphinidae
orcaella_heinsohni	Delphinidae
stenella_longirostris	Delphinidae
delphinus_delphis	Delphinidae
delphinus_capensis	Delphinidae
delphinus_tropicalis	Delphinidae
tursiops_aduncus	Delphinidae
stenella_clymene	Delphinidae
stenella_coeruleoalba	Delphinidae
stenella_frontalis	Delphinidae
tursiops_truncatus	Delphinidae
sousa_chinensis	Delphinidae
delphinidae_gen_sp_	Delphinidae
tursiops_australis	Delphinidae
lagenodelphis_hosei	Delphinidae
stenella_attenuata	Delphinidae
sotalia_guianensis	Delphinidae
sotalia_fluviatilis	Delphinidae
steno_bredanensis	Delphinidae
lagenorhynchus_albirostris	Delphinidae
lagenorhynchus_acutus	Delphinidae
phocoena_dioptrica	Phocoenidae
phocoena_sinus	Phocoenidae
phocoenoides_dalli	Phocoenidae
phocoena_phocoena	Phocoenidae
neophocaena_asiaeorientalis	Phocoenidae
neophocaena_phocaenoides_sunameri	Phocoenidae
monodon_monoceros	Monodontidae
delphinapterus_leucas	Monodontidae
inia_araguaiaensis	Iniidae
inia_geoffrensis	Iniidae
inia_boliviensis	Iniidae
pontoporia_blainvillei	Pontoporiidae
lipotes_vexillifer	Lipotidae
mesoplodon_peruvianus	Ziphiidae
mesoplodon_densirostris	Ziphiidae
mesoplodon_grayi	Ziphiidae
mesoplodon_ginkgodens	Ziphiidae
mesoplodon_europaeus	Ziphiidae
mesoplodon_bidens	Ziphiidae
mesoplodon_stejnegeri	Ziphiidae
indopacetus_pacificus	Ziphiidae
hyperoodon_ampullatus	Ziphiidae
ziphius_cavirostris	Ziphiidae
tasmacetus_shepherdi	Ziphiidae
berardius_bairdii	Ziphiidae
platanista_minor	Platanistidae
platanista_gangetica	Platanistidae
kogia_sima	Physeteridae
kogia_breviceps	Physeteridae
physeter_catodon	Physeteridae
balaenoptera_edeni	Balaenopteridae
balaenoptera_brydei	Balaenopteridae
balaenoptera_borealis	Balaenopteridae
balaenoptera_omurai	Balaenopteridae
balaenoptera_musculus	Balaenopteridae
megaptera_novaeangliae	Balaenopteridae
balaenoptera_physalus	Balaenopteridae
eschrichtius_robustus	Eschrichtiidae
balaenoptera_bonaerensis	Balaenopteridae
balaenoptera_acutorostrata	Balaenopteridae
caperea_marginata	Neobalaenidae
eubalaena_glacialis	Balaenidae
eubalaena_japonica	Balaenidae
eubalaena_australis	Balaenidae
balaena_mysticetus	Balaenidae
hexaprotodon_liberiensis	Hippopotamidae
hippopotamus_amphibius	Hippopotamidae
sus_scrofa_taiwanensis	Suidae
sus_barbatus	Suidae
sus_verrucosus	Suidae
sus_celebensis	Suidae
sus_cebifrons	Suidae
sus_philippensis	Suidae
phacochoerus_aethiopicus	Suidae
hylochoerus_meinertzhageni	Suidae
phacochoerus_africanus	Suidae
potamochoerus_larvatus	Suidae
potamochoerus_porcus	Suidae
babyrousa_celebensis	Suidae
babyrousa_babyrussa	Suidae
porcula_salvania	Suidae
tayassu_pecari	Tayassuidae
pecari_tajacu	Tayassuidae
catagonus_wagneri	Tayassuidae
lama_guanicoe	Camelidae
lama_glama_chaku	Camelidae
vicugna_pacos_huacaya	Camelidae
vicugna_vicugna_mensalis	Camelidae
camelus_ferus	Camelidae
camelus_bactrianus	Camelidae
camelus_dromedarius	Camelidae
manis_tricuspis	Manidae
manis_tetradactyla	Manidae
manis_temminckii	Manidae
manis_pentadactyla	Manidae
manis_javanica	Manidae
myonycteris_angolensis_ruwenzorii	Pteropodidae
myonycteris_relicta	Pteropodidae
myonycteris_leptodon	Pteropodidae
myonycteris_torquata	Pteropodidae
myonycteris_brachycephala	Pteropodidae
megaloglossus_woermanni	Pteropodidae
megaloglossus_azagnyi	Pteropodidae
epomophorus_gambianus	Pteropodidae
micropteropus_pusillus	Pteropodidae
epomophorus_wahlbergi	Pteropodidae
nanonycteris_veldkampii	Pteropodidae
epomops_franqueti	Pteropodidae
hypsignathus_monstrosus	Pteropodidae
stenonycteris_lanosus	Pteropodidae
rousettus_obliviosus	Pteropodidae
rousettus_madagascariensis	Pteropodidae
rousettus_aegyptiacus	Pteropodidae
rousettus_leschenaultii	Pteropodidae
rousettus_amplexicaudatus	Pteropodidae
aethalops_aequalis	Pteropodidae
eonycteris_robusta	Pteropodidae
eonycteris_spelaea	Pteropodidae
scotonycteris_bergmansi	Pteropodidae
scotonycteris_occidentalis	Pteropodidae
scotonycteris_zenkeri	Pteropodidae
casinycteris_argynnis	Pteropodidae
casinycteris_campomaanensis	Pteropodidae
scotonycteris_ophiodon	Pteropodidae
otopteropus_cartilagonodus	Pteropodidae
haplonycteris_fischeri	Pteropodidae
alionycteris_paucidentata	Pteropodidae
penthetor_lucasi	Pteropodidae
chironax_melanocephalus	Pteropodidae
latidens_salimalii	Pteropodidae
balionycteris_maculata	Pteropodidae
aethalops_alecto	Pteropodidae
sphaerias_blanfordi	Pteropodidae
dyacopterus_spadiceus	Pteropodidae
ptenochirus_jagori	Pteropodidae
megaerops_wetmorei	Pteropodidae
megaerops_kusnotoi	Pteropodidae
megaerops_ecaudatus	Pteropodidae
cynopterus_horsfieldii	Pteropodidae
cynopterus_sphinx	Pteropodidae
cynopterus_brachyotis	Pteropodidae
dobsonia_praedatrix	Pteropodidae
dobsonia_inermis	Pteropodidae
dobsonia_moluccensis	Pteropodidae
dobsonia_minor	Pteropodidae
aproteles_bulmerae	Pteropodidae
dobsonia_viridis	Pteropodidae
dobsonia_pannietensis	Pteropodidae
harpyionycteris_celebensis	Pteropodidae
harpyionycteris_whiteheadi	Pteropodidae
boneia_bidens	Pteropodidae
macroglossus_sobrinus	Pteropodidae
macroglossus_minimus	Pteropodidae
syconycteris_australis	Pteropodidae
notopteris_macdonaldi	Pteropodidae
nyctimene_certans	Pteropodidae
nyctimene_major	Pteropodidae
nyctimene_vizcaccia	Pteropodidae
nyctimene_albiventer	Pteropodidae
nyctimene_aello	Pteropodidae
nyctimene_cephalotes	Pteropodidae
nyctimene_robinsoni	Pteropodidae
paranyctimene_raptor	Pteropodidae
eidolon_dupreanum	Pteropodidae
eidolon_helvum	Pteropodidae
pteropus_yapensis	Pteropodidae
pteropus_pelewensis_pelewensis	Pteropodidae
pteropus_mariannus	Pteropodidae
pteropus_griseus	Pteropodidae
pteropus_pohlei	Pteropodidae
pteropus_hypomelanus	Pteropodidae
pteropus_admiralitatum	Pteropodidae
pteropus_tonganus	Pteropodidae
pteropus_conspicillatus	Pteropodidae
pteropus_alecto	Pteropodidae
pteropus_neohibernicus	Pteropodidae
pteropus_speciosus	Pteropodidae
pteropus_poliocephalus	Pteropodidae
pteropus_capistratus_ennisae	Pteropodidae
pteropus_gilliardorum	Pteropodidae
pteropus_woodfordi	Pteropodidae
pteropus_mahaganus	Pteropodidae
pteropus_pelagicus	Pteropodidae
pteropus_molossinus	Pteropodidae
pteropus_macrotis	Pteropodidae
pteropus_lombocensis	Pteropodidae
pteropus_scapulatus	Pteropodidae
pteropus_samoensis	Pteropodidae
pteropus_rayneri	Pteropodidae
pteropus_anetianus	Pteropodidae
pteropus_ornatus	Pteropodidae
pteropus_temminckii	Pteropodidae
pteropus_vetulus	Pteropodidae
pteropus_voeltzkowi	Pteropodidae
pteropus_livingstonii	Pteropodidae
pteropus_giganteus	Pteropodidae
pteropus_lylei	Pteropodidae
pteropus_niger	Pteropodidae
pteropus_seychellensis_seychellensis	Pteropodidae
pteropus_rufus	Pteropodidae
pteropus_aldabrensis	Pteropodidae
pteropus_rodricensis	Pteropodidae
pteropus_vampyrus	Pteropodidae
pteropus_faunulus	Pteropodidae
pteropus_dasymallus	Pteropodidae
pteropus_pumilus	Pteropodidae
acerodon_jubatus	Pteropodidae
acerodon_celebensis	Pteropodidae
pteropus_personatus	Pteropodidae
styloctenium_mindorensis	Pteropodidae
styloctenium_wallacei	Pteropodidae
thoopterus_nigrescens	Pteropodidae
pteralopex_atrata	Pteropodidae
pteralopex_taki	Pteropodidae
mirimiri_acrodonta	Pteropodidae
desmalopex_leucopterus	Pteropodidae
desmalopex_microleucopterus	Pteropodidae
melonycteris_fardoulisi	Pteropodidae
melonycteris_melanops	Pteropodidae
hipposideros_pomona	Hipposideridae
hipposideros_bicolor	Hipposideridae
hipposideros_rotalis	Hipposideridae
hipposideros_khaokhouayensis	Hipposideridae
hipposideros_ater	Hipposideridae
hipposideros_ridleyi	Hipposideridae
hipposideros_cineraceus	Hipposideridae
hipposideros_halophyllus	Hipposideridae
hipposideros_scutinares	Hipposideridae
hipposideros_doriae	Hipposideridae
hipposideros_dyacorum	Hipposideridae
hipposideros_fulvus	Hipposideridae
hipposideros_pelingensis	Hipposideridae
hipposideros_calcaratus	Hipposideridae
hipposideros_cervinus	Hipposideridae
hipposideros_coxi	Hipposideridae
hipposideros_galeritus	Hipposideridae
hipposideros_pygmaeus	Hipposideridae
hipposideros_speoris	Hipposideridae
hipposideros_lylei	Hipposideridae
hipposideros_pratti	Hipposideridae
hipposideros_turpis_turpis	Hipposideridae
hipposideros_alongensis_alongensis	Hipposideridae
hipposideros_diadema	Hipposideridae
hipposideros_dinops	Hipposideridae
hipposideros_lekaguli	Hipposideridae
hipposideros_demissus	Hipposideridae
hipposideros_pendleburyi	Hipposideridae
hipposideros_terasensis	Hipposideridae
hipposideros_armiger	Hipposideridae
hipposideros_griffini	Hipposideridae
hipposideros_larvatus	Hipposideridae
anthops_ornatus	Hipposideridae
hipposideros_obscurus	Hipposideridae
hipposideros_jonesi	Hipposideridae
hipposideros_coronatus	Hipposideridae
aselliscus_tricuspidatus	Hipposideridae
aselliscus_stoliczkanus	Hipposideridae
coelops_frithii	Hipposideridae
hipposideros_caffer_tephrus	Hipposideridae
hipposideros_ruber	Hipposideridae
hipposideros_fuliginosus	Hipposideridae
hipposideros_aff_ruber	Hipposideridae
hipposideros_beatus	Hipposideridae
hipposideros_abae	Hipposideridae
hipposideros_cyclops	Hipposideridae
hipposideros_gigas	Hipposideridae
hipposideros_vittatus	Hipposideridae
hipposideros_commersoni	Hipposideridae
asellia_tridens	Hipposideridae
triaenops_persicus	Rhinonycteridae
triaenops_menamena	Rhinonycteridae
triaenops_afer	Rhinonycteridae
rhinonicteris_aurantia	Rhinonycteridae
paratriaenops_furculus	Rhinonycteridae
paratriaenops_auritus	Rhinonycteridae
cloeotis_percivali	Rhinonycteridae
rhinolophus_virgo	Rhinolophidae
rhinolophus_megaphyllus	Rhinolophidae
rhinolophus_philippinensis	Rhinolophidae
rhinolophus_celebensis	Rhinolophidae
rhinolophus_paradoxolophus	Rhinolophidae
rhinolophus_rex	Rhinolophidae
rhinolophus_macrotis	Rhinolophidae
rhinolophus_marshalli	Rhinolophidae
rhinolophus_pumilus	Rhinolophidae
rhinolophus_perditus	Rhinolophidae
rhinolophus_cornutus	Rhinolophidae
rhinolophus_blythi	Rhinolophidae
rhinolophus_pusillus	Rhinolophidae
rhinolophus_monoceros	Rhinolophidae
rhinolophus_malayanus	Rhinolophidae
rhinolophus_arcuatus	Rhinolophidae
rhinolophus_inops_arcuatus	Vespertilionidae
rhinolophus_subrufus	Rhinolophidae
rhinolophus_euryotis	Rhinolophidae
rhinolophus_creaghi	Rhinolophidae
rhinolophus_shameli	Rhinolophidae
rhinolophus_affinis	Rhinolophidae
rhinolophus_stheno	Rhinolophidae
rhinolophus_thomasi	Rhinolophidae
rhinolophus_sinicus	Rhinolophidae
rhinolophus_rouxii	Rhinolophidae
rhinolophus_pearsonii	Rhinolophidae
rhinolophus_yunnanensis	Rhinolophidae
rhinolophus_darlingi	Rhinolophidae
rhinolophus_hildebrandti	Rhinolophidae
rhinolophus_fumigatus	Rhinolophidae
rhinolophus_eloquens	Rhinolophidae
rhinolophus_ruwenzorii	Rhinolophidae
rhinolophus_clivosus	Rhinolophidae
rhinolophus_ferrumequinum	Rhinolophidae
rhinolophus_xinanzhongguoensis	Rhinolophidae
rhinolophus_denti	Rhinolophidae
rhinolophus_simulator	Rhinolophidae
rhinolophus_swinnyi	Rhinolophidae
rhinolophus_blasii	Rhinolophidae
rhinolophus_euryale	Rhinolophidae
rhinolophus_mehelyi	Rhinolophidae
rhinolophus_landeri	Rhinolophidae
rhinolophus_alcyone	Rhinolophidae
rhinolophus_trifoliatus	Rhinolophidae
rhinolophus_luctus	Rhinolophidae
rhinolophus_formosae	Rhinolophidae
rhinolophus_hipposideros	Rhinolophidae
macroderma_gigas	Megadermatidae
megaderma_spasma	Megadermatidae
megaderma_lyra	Megadermatidae
cardioderma_cor	Megadermatidae
craseonycteris_thonglongyai	Craseonycteridae
rhinopoma_muscatellum	Rhinopomatidae
rhinopoma_hadramauticum	Rhinopomatidae
rhinopoma_microphyllum	Rhinopomatidae
rhinopoma_hardwickii_cystops	Rhinopomatidae
laephotis_wintoni	Vespertilionidae
laephotis_namibensis	Vespertilionidae
laephotis_botswanae	Vespertilionidae
neoromicia_matroka	Vespertilionidae
neoromicia_capensis	Vespertilionidae
neoromicia_robertsi	Vespertilionidae
neoromicia_malagasyensis	Vespertilionidae
neoromicia_guineensis	Vespertilionidae
neoromicia_somalicus	Vespertilionidae
neoromicia_zuluensis	Vespertilionidae
hypsugo_anchietae	Vespertilionidae
neoromicia_rendalli	Vespertilionidae
neoromicia_tenuipinnis	Vespertilionidae
neoromicia_brunneus	Vespertilionidae
neoromicia_nanus	Vespertilionidae
hypsugo_eisentrauti	Vespertilionidae
nycticeinops_schlieffeni	Vespertilionidae
chalinolobus_tuberculatus	Vespertilionidae
chalinolobus_gouldii	Vespertilionidae
chalinolobus_nigrogriseus	Vespertilionidae
chalinolobus_morio	Vespertilionidae
nyctophilus_geoffroyi	Vespertilionidae
nyctophilus_gouldi	Vespertilionidae
vespadelus_regulus	Vespertilionidae
vespadelus_vulturnus	Vespertilionidae
vespadelus_darlingtoni	Vespertilionidae
scotorepens_sp_jmw_2004	Vespertilionidae
falsistrellus_petersi	Vespertilionidae
hypsugo_savii	Vespertilionidae
hypsugo_alaschanicus	Vespertilionidae
hypsugo_cadornae	Vespertilionidae
hypsugo_ariel	Vespertilionidae
tylonycteris_robustula	Vespertilionidae
tylonycteris_pachypus	Vespertilionidae
vespertilio_murinus	Vespertilionidae
vespertilio_sinensis	Vespertilionidae
pipistrellus_maderensis	Vespertilionidae
pipistrellus_deserti	Vespertilionidae
pipistrellus_kuhlii	Vespertilionidae
pipistrellus_hesperidus	Vespertilionidae
pipistrellus_pygmaeus	Vespertilionidae
pipistrellus_hanaki	Vespertilionidae
pipistrellus_pipistrellus	Vespertilionidae
pipistrellus_raceyi	Vespertilionidae
pipistrellus_nathusii	Vespertilionidae
nyctalus_aviator	Vespertilionidae
nyctalus_lasiopterus	Vespertilionidae
nyctalus_leisleri	Vespertilionidae
nyctalus_plancyi	Vespertilionidae
nyctalus_velutinus	Vespertilionidae
nyctalus_noctula	Vespertilionidae
pipistrellus_ceylonicus	Vespertilionidae
pipistrellus_coromandra	Vespertilionidae
pipistrellus_tenuis	Vespertilionidae
pipistrellus_javanicus	Vespertilionidae
pipistrellus_paterculus	Vespertilionidae
pipistrellus_abramus	Vespertilionidae
glischropus_tylopus	Vespertilionidae
glischropus_aquilus	Vespertilionidae
glischropus_bucephalus	Vespertilionidae
pipistrellus_rueppellii	Vespertilionidae
scotoecus_hirundo	Vespertilionidae
eptesicus_serotinus_turcomanus	Vespertilionidae
eptesicus_isabellinus_boscai	Vespertilionidae
eptesicus_bottae	Vespertilionidae
eptesicus_gobiensis	Vespertilionidae
eptesicus_bobrinskoi	Vespertilionidae
eptesicus_nilssonii	Vespertilionidae
eptesicus_hottentotus	Vespertilionidae
eptesicus_brasiliensis	Vespertilionidae
eptesicus_furinalis	Vespertilionidae
eptesicus_diminutus	Vespertilionidae
eptesicus_macrotus	Vespertilionidae
eptesicus_magellanicus	Vespertilionidae
eptesicus_fuscus	Vespertilionidae
ia_io	Vespertilionidae
scotomanes_ornatus	Vespertilionidae
nycticeius_humeralis	Vespertilionidae
glauconycteris_egeria	Vespertilionidae
glauconycteris_argentata	Vespertilionidae
glauconycteris_variegata	Vespertilionidae
glauconycteris_poensis	Vespertilionidae
glauconycteris_beatrix	Vespertilionidae
philetor_brachypterus	Vespertilionidae
hesperoptenus_tomesi	Vespertilionidae
hesperoptenus_blanfordi	Vespertilionidae
arielulus_cuprosus	Vespertilionidae
arielulus_aureocollaris	Vespertilionidae
lasionycteris_noctivagans	Vespertilionidae
perimyotis_subflavus	Vespertilionidae
parastrellus_hesperus	Vespertilionidae
plecotus_ognevi	Vespertilionidae
plecotus_auritus	Vespertilionidae
plecotus_sacrimontis	Vespertilionidae
plecotus_macrobullaris	Vespertilionidae
plecotus_sardus	Vespertilionidae
plecotus_turkmenicus	Vespertilionidae
plecotus_teneriffae_gaisleri	Vespertilionidae
plecotus_kolombatovici	Vespertilionidae
plecotus_austriacus	Vespertilionidae
otonycteris_hemprichii	Vespertilionidae
otonycteris_leucophaea	Vespertilionidae
corynorhinus_townsendii	Vespertilionidae
corynorhinus_mexicanus	Vespertilionidae
corynorhinus_rafinesquii	Vespertilionidae
barbastella_barbastellus	Vespertilionidae
barbastella_beijingensis	Vespertilionidae
barbastella_leucomelas	Vespertilionidae
euderma_maculatum	Vespertilionidae
idionycteris_phyllotis	Vespertilionidae
rhogeessa_aeneus	Vespertilionidae
rhogeessa_velilla	Vespertilionidae
rhogeessa_io	Vespertilionidae
rhogeessa_genowaysi	Vespertilionidae
rhogeessa_tumida	Vespertilionidae
rhogeessa_mira	Vespertilionidae
rhogeessa_parvula	Vespertilionidae
rhogeessa_alleni	Vespertilionidae
rhogeessa_gracilis	Vespertilionidae
antrozous_pallidus	Vespertilionidae
antrozous_dubiaquercus	Vespertilionidae
lasiurus_atratus	Vespertilionidae
lasiurus_blossevillii	Vespertilionidae
lasiurus_seminolus	Vespertilionidae
lasiurus_borealis	Vespertilionidae
lasiurus_intermedius	Vespertilionidae
lasiurus_cinereus_semotus	Vespertilionidae
lasiurus_ega	Vespertilionidae
lasiurus_xanthinus	Vespertilionidae
scotophilus_viridis_nigritellus	Vespertilionidae
scotophilus_dinganii	Vespertilionidae
scotophilus_borbonicus	Vespertilionidae
scotophilus_robustus	Vespertilionidae
scotophilus_nigrita	Vespertilionidae
scotophilus_leucogaster	Vespertilionidae
scotophilus_tandrefana	Vespertilionidae
scotophilus_marovaza	Vespertilionidae
scotophilus_heathii	Vespertilionidae
scotophilus_nux	Vespertilionidae
scotophilus_kuhlii	Vespertilionidae
myotis_hasseltii	Vespertilionidae
myotis_adversus_tanimbarensis	Vespertilionidae
myotis_macropus	Vespertilionidae
myotis_macrotarsus	Vespertilionidae
myotis_horsfieldii	Vespertilionidae
myotis_rosseti	Vespertilionidae
myotis_ridleyi	Vespertilionidae
myotis_muricola_browni	Vespertilionidae
myotis_yanbarensis	Vespertilionidae
myotis_secundus	Vespertilionidae
myotis_pruinosus	Vespertilionidae
myotis_montivagus	Vespertilionidae
myotis_annectans	Vespertilionidae
myotis_fimbriatus	Vespertilionidae
myotis_ricketti	Vespertilionidae
myotis_daubentonii	Vespertilionidae
myotis_petax	Vespertilionidae
myotis_hajastanicus	Vespertilionidae
myotis_macrodactylus	Vespertilionidae
myotis_siligorensis	Vespertilionidae
myotis_davidii	Vespertilionidae
myotis_phanluongi	Vespertilionidae
myotis_csorbai	Vespertilionidae
myotis_longipes	Vespertilionidae
myotis_laniger	Vespertilionidae
myotis_annamiticus	Vespertilionidae
myotis_capaccinii	Vespertilionidae
myotis_bombinus_amurensis	Vespertilionidae
myotis_nattereri	Vespertilionidae
myotis_pequinius	Vespertilionidae
myotis_schaubi	Vespertilionidae
myotis_escalerai	Vespertilionidae
myotis_chinensis	Vespertilionidae
myotis_blythii_omari	Vespertilionidae
myotis_oxygnathus	Vespertilionidae
myotis_myotis_blythii	Vespertilionidae
myotis_punicus	Vespertilionidae
myotis_frater	Vespertilionidae
myotis_nathalinae	Vespertilionidae
myotis_bechsteinii	Vespertilionidae
myotis_sicarius	Vespertilionidae
myotis_tricolor	Vespertilionidae
myotis_emarginatus	Vespertilionidae
myotis_flavus	Vespertilionidae
myotis_scotti	Vespertilionidae
myotis_goudoti	Vespertilionidae
myotis_anjouanensis	Vespertilionidae
myotis_watasei	Vespertilionidae
myotis_formosus	Vespertilionidae
myotis_rufoniger	Vespertilionidae
myotis_welwitschii	Vespertilionidae
myotis_bocagii_cupreolus	Vespertilionidae
myotis_altarium	Vespertilionidae
myotis_ikonnikovi	Vespertilionidae
myotis_alcathoe	Vespertilionidae
myotis_aurascens	Vespertilionidae
myotis_dasycneme	Vespertilionidae
myotis_aff_alcathoe	Vespertilionidae
myotis_ater	Vespertilionidae
myotis_nesopolus_nesopolus	Vespertilionidae
myotis_martiniquensis	Vespertilionidae
myotis_atacamensis	Vespertilionidae
myotis_dominicensis	Vespertilionidae
myotis_grisescens	Vespertilionidae
myotis_austroriparius	Vespertilionidae
myotis_velifer	Vespertilionidae
myotis_yumanensis	Vespertilionidae
myotis_oxyotus	Vespertilionidae
myotis_nigricans	Vespertilionidae
myotis_albescens	Vespertilionidae
myotis_levis	Vespertilionidae
myotis_chiloensis	Vespertilionidae
myotis_fortidens	Vespertilionidae
myotis_vivesi	Vespertilionidae
myotis_riparius	Vespertilionidae
myotis_elegans	Vespertilionidae
myotis_simus	Vespertilionidae
myotis_ruber	Vespertilionidae
myotis_keaysi	Vespertilionidae
myotis_mystacinus	Vespertilionidae
myotis_gracilis	Vespertilionidae
myotis_brandtii	Vespertilionidae
myotis_keenii	Vespertilionidae
myotis_evotis	Vespertilionidae
myotis_thysanodes	Vespertilionidae
myotis_lucifugus	Vespertilionidae
myotis_volans	Vespertilionidae
myotis_sodalis	Vespertilionidae
myotis_melanorhinus	Vespertilionidae
myotis_ciliolabrum	Vespertilionidae
myotis_californicus	Vespertilionidae
myotis_leibii	Vespertilionidae
myotis_auriculus	Vespertilionidae
myotis_septentrionalis	Vespertilionidae
eudiscopus_denticulus	Vespertilionidae
submyotodon_latirostris	Vespertilionidae
murina_florium	Vespertilionidae
murina_suilla	Vespertilionidae
murina_rozendaali	Vespertilionidae
murina_aenea	Vespertilionidae
murina_tubinaris	Vespertilionidae
murina_cineracea	Vespertilionidae
murina_jaintiana	Vespertilionidae
murina_gracilis	Vespertilionidae
murina_recondita	Vespertilionidae
murina_aurata	Vespertilionidae
murina_eleryi	Vespertilionidae
murina_peninsularis	Vespertilionidae
murina_cyclotis	Vespertilionidae
murina_pluvialis	Vespertilionidae
murina_leucogaster	Vespertilionidae
murina_hilgendorfi	Vespertilionidae
murina_bicolor	Vespertilionidae
murina_huttoni	Vespertilionidae
murina_puta	Vespertilionidae
murina_tiensa	Vespertilionidae
murina_ryukyuna	Vespertilionidae
murina_ussuriensis	Vespertilionidae
harpiola_isodon	Vespertilionidae
harpiocephalus_harpia	Vespertilionidae
harpiocephalus_mordax	Vespertilionidae
kerivoula_kachinensis	Vespertilionidae
kerivoula_titania	Vespertilionidae
kerivoula_hardwickii	Vespertilionidae
kerivoula_intermedia	Vespertilionidae
kerivoula_minuta	Vespertilionidae
kerivoula_whiteheadi	Vespertilionidae
kerivoula_papillosa	Vespertilionidae
kerivoula_lenis	Vespertilionidae
kerivoula_pellucida	Vespertilionidae
cistugo_seabrae	Cistugidae
cistugo_lesueuri	Cistugidae
miniopterus_fraterculus	Miniopteridae
miniopterus_minor	Miniopteridae
miniopterus_griveaudi	Miniopteridae
miniopterus_inflatus	Miniopteridae
miniopterus_sororculus	Miniopteridae
miniopterus_griffithsi	Miniopteridae
miniopterus_gleni	Miniopteridae
miniopterus_majori	Miniopteridae
miniopterus_africanus	Miniopteridae
miniopterus_natalensis	Miniopteridae
miniopterus_aelleni	Miniopteridae
miniopterus_manavi	Miniopteridae
miniopterus_petersoni	Miniopteridae
miniopterus_schreibersii_pallidus	Miniopteridae
miniopterus_maghrebensis	Miniopteridae
miniopterus_pusillus	Miniopteridae
miniopterus_australis	Miniopteridae
miniopterus_propitristis	Miniopteridae
miniopterus_tristis	Miniopteridae
miniopterus_fuliginosus	Miniopteridae
miniopterus_fuscus	Miniopteridae
miniopterus_magnater	Miniopteridae
eumops_floridanus	Molossidae
eumops_ferox	Molossidae
eumops_glaucinus	Molossidae
eumops_wilsoni	Molossidae
eumops_dabbenei	Molossidae
eumops_underwoodi	Molossidae
eumops_perotis	Molossidae
eumops_maurus	Molossidae
eumops_auripendulus	Molossidae
eumops_patagonicus	Molossidae
eumops_bonariensis	Molossidae
eumops_hansae	Molossidae
nyctinomops_aurispinosus	Molossidae
nyctinomops_femorosaccus	Molossidae
nyctinomops_macrotis	Molossidae
molossops_mattogrossensis	Molossidae
cynomops	Molossidae
molossops_temminckii	Molossidae
molossus_ater	Molossidae
molossus_rufus	Molossidae
molossus_molossus	Molossidae
molossus_sinaloae	Molossidae
promops_centralis	Molossidae
otomops_madagascariensis	Molossidae
otomops_martiensseni	Molossidae
otomops_wroughtoni	Molossidae
mormopterus_lumsdenae	Molossidae
mormopterus_beccarii	Molossidae
mormopterus_ridei	Molossidae
mormopterus_planiceps	Molossidae
mormopterus_kitcheneri	Molossidae
mormopterus_petersi	Molossidae
mormopterus_halli	Molossidae
mormopterus_cobourgianus	Molossidae
mormopterus_loriae	Molossidae
tadarida_australis	Molossidae
mormopterus_eleryi	Molossidae
mormopterus_norfolkensis	Molossidae
tadarida_brasiliensis	Molossidae
sauromys_petrophilus	Molossidae
myopterus_daubentonii	Molossidae
chaerephon_pumilus_s_l_tn_2014	Molossidae
chaerephon_leucogaster	Molossidae
chaerephon_atsinanana	Molossidae
chaerephon_pusillus	Molossidae
mops_bakarii	Molossidae
mops_condylurus	Molossidae
mops_leucostigma	Molossidae
chaerephon_plicatus	Molossidae
mops_midas	Molossidae
chaerephon_jobimena	Molossidae
tadarida_insignis	Molossidae
tadarida_teniotis	Molossidae
tadarida_aegyptiaca	Molossidae
tadarida_fulminans	Molossidae
cheiromeles	Molossidae
natalus_major	Natalidae
natalus_jamaicensis	Natalidae
natalus_saturatus	Natalidae
natalus_tumidirostris	Natalidae
natalus_stramineus	Natalidae
nyctiellus_lepidus	Natalidae
chilonatalus_tumidifrons	Natalidae
chilonatalus_micropus	Natalidae
artibeus_planirostris_fallax	Phyllostomidae
artibeus_amplus	Phyllostomidae
artibeus_lituratus	Phyllostomidae
artibeus_intermedius	Phyllostomidae
artibeus_schwartzi	Phyllostomidae
artibeus_obscurus	Phyllostomidae
artibeus_jamaicensis_parvipes	Phyllostomidae
artibeus_fimbriatus	Phyllostomidae
artibeus_fraterculus	Phyllostomidae
artibeus_hirsutus	Phyllostomidae
artibeus_inopinatus	Phyllostomidae
artibeus_concolor	Phyllostomidae
artibeus_anderseni	Phyllostomidae
artibeus_rava	Dermanura
artibeus_cinereus	Phyllostomidae
artibeus_gnomus	Phyllostomidae
artibeus_bogotensis	Phyllostomidae
artibeus_glaucus	Phyllostomidae
artibeus_aztecus	Phyllostomidae
artibeus_phaeotis	Phyllostomidae
artibeus_toltecus	Phyllostomidae
artibeus_watsoni	Phyllostomidae
ametrida_centurio	Phyllostomidae
pygoderma_bilabiatum	Phyllostomidae
sphaeronycteris_toxophyllum	Phyllostomidae
centurio_senex_greenhalli	Phyllostomidae
phyllops_falcatus	Phyllostomidae
stenoderma_rufum	Phyllostomidae
ariteus_flavescens	Phyllostomidae
ardops_nichollsi	Phyllostomidae
enchisthenes_hartii	Phyllostomidae
ectophylla_alba	Phyllostomidae
platyrrhinus_ismaeli	Phyllostomidae
platyrrhinus_masu	Phyllostomidae
platyrrhinus_nigellus	Phyllostomidae
platyrrhinus_infuscus	Phyllostomidae
platyrrhinus_aurarius	Phyllostomidae
platyrrhinus_dorsalis	Phyllostomidae
platyrrhinus_vittatus	Phyllostomidae
platyrrhinus_albericoi	Phyllostomidae
platyrrhinus_guianensis	Phyllostomidae
platyrrhinus_recifinus	Phyllostomidae
platyrrhinus_incarum	Phyllostomidae
platyrrhinus_helleri	Phyllostomidae
platyrrhinus_matapalensis	Phyllostomidae
platyrrhinus_brachycephalus	Phyllostomidae
platyrrhinus_lineatus	Phyllostomidae
vampyrodes_caraccioli	Phyllostomidae
vampyrodes_major	Phyllostomidae
vampyressa_pusilla	Phyllostomidae
vampyressa_thyone	Phyllostomidae
vampyressa_melissa	Phyllostomidae
mesophylla_macconnelli	Phyllostomidae
chiroderma_improvisum	Phyllostomidae
chiroderma_doriae	Phyllostomidae
chiroderma_trinitatum	Phyllostomidae
chiroderma_villosum	Phyllostomidae
chiroderma_salvini	Phyllostomidae
vampyriscus_brocki	Phyllostomidae
vampyriscus_nymphaea	Phyllostomidae
vampyriscus_bidens	Phyllostomidae
uroderma_magnirostrum	Phyllostomidae
uroderma_bilobatum	Phyllostomidae
sturnira_bogotensis	Phyllostomidae
sturnira_magna	Phyllostomidae
sturnira_erythromos	Phyllostomidae
sturnira_tildae	Phyllostomidae
sturnira_mordax	Phyllostomidae
sturnira_oporaphilum	Phyllostomidae
sturnira_ludovici	Phyllostomidae
sturnira_hondurensis	Phyllostomidae
sturnira_paulsoni	Phyllostomidae
sturnira_luisi	Phyllostomidae
sturnira_parvidens	Phyllostomidae
sturnira_lilium	Phyllostomidae
sturnira_aratathomasi	Phyllostomidae
sturnira_bidens	Phyllostomidae
rhinophylla_fischerae	Phyllostomidae
rhinophylla_pumilio	Phyllostomidae
rhinophylla_alethina	Phyllostomidae
carollia_brevicauda	Phyllostomidae
carollia_castanea	Phyllostomidae
carollia_perspicillata	Phyllostomidae
carollia_manu	Phyllostomidae
carollia_subrufa	Phyllostomidae
carollia_sowelli	Phyllostomidae
carollia_benkeithi	Phyllostomidae
glyphonycteris_daviesi	Phyllostomidae
phyllostomus_latifolius	Phyllostomidae
glyphonycteris_sylvestris	Phyllostomidae
trinycteris_nicefori	Phyllostomidae
lonchophylla_concava	Phyllostomidae
lonchophylla_mordax	Phyllostomidae
lonchophylla_hesperia	Phyllostomidae
lionycteris_spurrelli	Phyllostomidae
lonchophylla_dekeyseri	Phyllostomidae
lonchophylla_orienticollina	Phyllostomidae
lonchophylla_robusta	Phyllostomidae
lonchophylla_handleyi	Phyllostomidae
lonchophylla_chocoana	Phyllostomidae
hsunycteris_pattoni	Phyllostomidae
hsunycteris_thomasi	Phyllostomidae
hsunycteris_cadenai	Phyllostomidae
platalina_genovensium	Phyllostomidae
xeronycteris_vieirai	Phyllostomidae
lonchorhina_inusitata	Phyllostomidae
lonchorhina_aurita	Phyllostomidae
lonchorhina_orinocensis	Phyllostomidae
glossophaga_longirostris	Phyllostomidae
glossophaga_leachii	Phyllostomidae
glossophaga_commissarisi	Phyllostomidae
glossophaga_morenoi	Phyllostomidae
glossophaga_soricina	Phyllostomidae
leptonycteris_curasoae	Phyllostomidae
leptonycteris_yerbabuenae	Phyllostomidae
leptonycteris_nivalis	Phyllostomidae
monophyllus_plethodon	Phyllostomidae
monophyllus_redmani	Phyllostomidae
phyllonycteris_obtusa	Phyllostomidae
phyllonycteris_poeyi	Phyllostomidae
phyllonycteris_aphylla	Phyllostomidae
erophylla_bombifrons	Phyllostomidae
erophylla_sezekorni	Phyllostomidae
brachyphylla_pumila	Phyllostomidae
brachyphylla_cavernarum	Phyllostomidae
brachyphylla_nana	Phyllostomidae
lichonycteris_obscura	Phyllostomidae
choeroniscus	Phyllostomidae
musonycteris_harrisoni	Phyllostomidae
choeronycteris_mexicana	Phyllostomidae
hylonycteris_underwoodi	Phyllostomidae
anoura_caudifer	Phyllostomidae
anoura_cultrata	Phyllostomidae
anoura_geoffroyi	Phyllostomidae
anoura_latidens	Phyllostomidae
lophostoma_occidentalis	Phyllostomidae
lophostoma_schulzi	Phyllostomidae
lophostoma_carrikeri	Phyllostomidae
lophostoma_brasiliense	Phyllostomidae
lophostoma_evotis	Phyllostomidae
lophostoma_silvicolum	Phyllostomidae
phyllostomus_hastatus	Phyllostomidae
phyllostomus_elongatus	Phyllostomidae
mimon_crenulatum	Phyllostomidae
phylloderma_stenops	Phyllostomidae
phyllostomus_discolor	Phyllostomidae
tonatia_saurophila	Phyllostomidae
tonatia_bidens	Phyllostomidae
macrophyllum_macrophyllum	Phyllostomidae
trachops_cirrhosus	Phyllostomidae
mimon_cozumelae	Phyllostomidae
vampyrum_spectrum	Phyllostomidae
chrotopterus_auritus	Phyllostomidae
diaemus_youngi	Phyllostomidae
desmodus_rotundus	Phyllostomidae
diphylla_ecaudata	Phyllostomidae
micronycteris_microtis	Phyllostomidae
micronycteris_megalotis	Phyllostomidae
micronycteris_buriri	Phyllostomidae
micronycteris_matses	Phyllostomidae
micronycteris_giovanniae	Phyllostomidae
micronycteris_brosseti	Phyllostomidae
micronycteris_hirsuta	Phyllostomidae
micronycteris_schmidtorum	Phyllostomidae
micronycteris_homezi	Phyllostomidae
micronycteris_minuta	Phyllostomidae
micronycteris_yatesi	Phyllostomidae
micronycteris_brachyotis	Phyllostomidae
macrotus_waterhousii	Phyllostomidae
macrotus_californicus	Phyllostomidae
pteronotus_davyi	Mormoopidae
pteronotus_gymnonotus	Mormoopidae
pteronotus_macleayii	Mormoopidae
pteronotus_quadridens	Mormoopidae
pteronotus_personatus	Mormoopidae
pteronotus_parnellii	Mormoopidae
pteronotus_pusillus	Mormoopidae
pteronotus_rubiginosus	Mormoopidae
mormoops_megalophylla	Mormoopidae
mormoops_blainvillei	Mormoopidae
noctilio_albiventris	Noctilionidae
noctilio_leporinus	Noctilionidae
furipterus_horrens	Furipteridae
thyroptera_tricolor	Thyropteridae
thyroptera_lavali	Thyropteridae
thyroptera_discifera	Thyropteridae
mystacina_tuberculata	Mystacinidae
myzopoda_schliemanni	Myzopodidae
myzopoda_aurita	Myzopodidae
diclidurus_albus	Emballonuridae
diclidurus_ingens	Emballonuridae
diclidurus_scutatus	Emballonuridae
diclidurus_isabellus	Emballonuridae
cyttarops_alecto	Emballonuridae
peropteryx_macrotis	Emballonuridae
peropteryx_trinitatis	Emballonuridae
peropteryx_kappleri	Emballonuridae
peropteryx_leucoptera	Emballonuridae
cormura_brevirostris	Emballonuridae
balantiopteryx_io	Emballonuridae
balantiopteryx_infusca	Emballonuridae
balantiopteryx_plicata	Emballonuridae
saccopteryx_canescens	Emballonuridae
saccopteryx_gymnura	Emballonuridae
saccopteryx_leptura	Emballonuridae
saccopteryx_bilineata	Emballonuridae
rhynchonycteris_naso	Emballonuridae
centronycteris_centralis	Emballonuridae
centronycteris_maximiliani	Emballonuridae
emballonura_alecto	Emballonuridae
emballonura_monticola	Emballonuridae
emballonura_semicaudata	Emballonuridae
emballonura_raffrayana	Emballonuridae
emballonura_dianae	Emballonuridae
emballonura_beccarii	Emballonuridae
coleura_seychellensis	Emballonuridae
coleura_kibomalandy	Emballonuridae
coleura_afra	Emballonuridae
paremballonura_tiavato	Emballonuridae
paremballonura_atrata	Emballonuridae
taphozous_australis	Emballonuridae
taphozous_georgianus	Emballonuridae
taphozous_hilli	Emballonuridae
taphozous_melanopogon	Emballonuridae
taphozous_nudiventris	Emballonuridae
taphozous_longimanus	Emballonuridae
taphozous_mauritianus	Emballonuridae
saccolaimus	Emballonuridae
nycteris_arge	Nycteridae
nycteris_grandis	Nycteridae
nycteris_hispida	Nycteridae
nycteris_thebaica	Nycteridae
nycteris_tragata	Nycteridae
nycteris_javanica	Nycteridae
crocidura_ninoyi	Soricidae
crocidura_panayensis	Soricidae
crocidura_negrina	Soricidae
crocidura_grayi_halconus	Soricidae
crocidura_beatus	Soricidae
crocidura_mindorus	Soricidae
crocidura_palawanensis	Soricidae
crocidura_neglecta	Soricidae
crocidura_negligens	Soricidae
crocidura_malayana	Soricidae
crocidura_nigripes_lipara	Soricidae
crocidura_foetida	Soricidae
crocidura_beccarii	Soricidae
crocidura_lepidura	Soricidae
crocidura_orientalis	Soricidae
crocidura_brunnea	Soricidae
crocidura_paradoxura	Soricidae
crocidura_fuliginosa	Soricidae
crocidura_wuchihensis	Soricidae
crocidura_indochinensis	Soricidae
crocidura_phuquocensis	Soricidae
crocidura_tanakae	Soricidae
crocidura_lasiura	Soricidae
crocidura_dsinezumi	Soricidae
crocidura_rapax_kurodai	Soricidae
crocidura_zaitsevi	Soricidae
crocidura_attenuata	Soricidae
crocidura_monticola	Soricidae
crocidura_maxi	Soricidae
crocidura_watasei	Soricidae
crocidura_phanluongi	Soricidae
crocidura_sokolovi	Soricidae
crocidura_miya	Soricidae
crocidura_hikmiya	Soricidae
crocidura_horsfieldii	Soricidae
crocidura_sibirica	Soricidae
crocidura_suaveolens_gueldenstaedtii	Soricidae
crocidura_caspica	Soricidae
crocidura_monacha	Soricidae
crocidura_aleksandrisi	Soricidae
crocidura_zarudnyi	Soricidae
crocidura_shantungensis	Soricidae
crocidura_orii	Soricidae
diplomesodon_pulchellum	Soricidae
crocidura_newmarki	Soricidae
crocidura_monax	Soricidae
crocidura_usambarae	Soricidae
crocidura_tansaniana	Soricidae
crocidura_fumosa	Soricidae
crocidura_mdumai	Soricidae
crocidura_munissii	Soricidae
crocidura_luna	Soricidae
crocidura_macmillani	Soricidae
crocidura_baileyi	Soricidae
crocidura_glassi	Soricidae
crocidura_zimmermanni	Soricidae
crocidura_eburnea	Soricidae
crocidura_obscurior	Soricidae
crocidura_canariensis	Soricidae
crocidura_tarfayensis	Soricidae
crocidura_sicula	Soricidae
crocidura_leucodon	Soricidae
crocidura_levicula	Soricidae
crocidura_rhoditis	Soricidae
crocidura_musseri	Soricidae
crocidura_batakorum	Soricidae
crocidura_olivieri_giffardi	Soricidae
crocidura_fulvastra	Soricidae
crocidura_viaria	Soricidae
crocidura_goliath	Soricidae
crocidura_somalica	Soricidae
crocidura_flavescens	Soricidae
crocidura_hirta	Soricidae
crocidura_lamottei	Soricidae
crocidura_parvipes	Soricidae
crocidura_nimbasilvanus	Soricidae
crocidura_nimbae	Soricidae
crocidura_muricauda	Soricidae
crocidura_douceti	Soricidae
crocidura_nanilla	Soricidae
crocidura_fingui	Soricidae
crocidura_poensis	Soricidae
crocidura_buettikoferi	Soricidae
crocidura_wimmeri	Soricidae
crocidura_theresae	Soricidae
crocidura_grandiceps	Soricidae
crocidura_batesi	Soricidae
crocidura_hildegardeae	Soricidae
crocidura_silacea	Soricidae
crocidura_mariquensis	Soricidae
crocidura_cyanea	Soricidae
crocidura_jouvenetae	Soricidae
crocidura_crossei	Soricidae
crocidura_lusitania	Soricidae
crocidura_fuscomurina	Soricidae
crocidura_grassei	Soricidae
crocidura_crenata	Soricidae
crocidura_roosevelti	Soricidae
crocidura_ichnusae	Soricidae
crocidura_russula	Soricidae
suncus_etruscus	Soricidae
suncus_madagascariensis	Soricidae
suncus_malayanus	Soricidae
suncus_fellowesgordoni	Soricidae
suncus_murinus_kandianus	Soricidae
suncus_montanus	Soricidae
suncus_stoliczkanus	Soricidae
suncus_dayi	Soricidae
feroculus_feroculus	Soricidae
sylvisorex_vulcanorum	Soricidae
sylvisorex_granti_mundus	Soricidae
sylvisorex_lunaris	Soricidae
sylvisorex_johnstoni	Soricidae
suncus_remyi	Soricidae
suncus_hututsi	Soricidae
suncus_infinitesimus	Soricidae
suncus_varilla	Soricidae
sylvisorex_ollula	Soricidae
suncus_megalura	Soricidae
sylvisorex_howelli	Soricidae
suncus_lixus	Soricidae
solisorex_pearsoni	Soricidae
myosorex_varius	Soricidae
myosorex_cafer	Soricidae
myosorex_sclateri	Soricidae
myosorex_zinki	Soricidae
myosorex_geata	Soricidae
myosorex_kihaulei	Soricidae
congosorex_phillipsorum	Soricidae
sorex_camtschatica	Soricidae
sorex_jacksoni	Soricidae
sorex_hydrodromus	Soricidae
sorex_portenkoi	Soricidae
sorex_lyelli	Soricidae
sorex_haydeni	Soricidae
sorex_preblei	Soricidae
sorex_ugyunak	Soricidae
sorex_cinereus	Soricidae
sorex_milleri	Soricidae
sorex_longirostris	Soricidae
sorex_dispar_dispar	Soricidae
sorex_gaspensis	Soricidae
sorex_fumeus	Soricidae
sorex_hoyi	Soricidae
sorex_thompsoni	Soricidae
sorex_palustris_navigator	Soricidae
sorex_bendirii_bendirii	Soricidae
sorex_bairdi	Soricidae
sorex_monticolus	Soricidae
sorex_pacificus	Soricidae
sorex_ornatus	Soricidae
sorex_vagrans	Soricidae
sorex_rohweri	Soricidae
sorex_tenellus	Soricidae
sorex_trowbridgii	Soricidae
sorex_arizonae	Soricidae
sorex_saussurei	Soricidae
sorex_satunini	Soricidae
sorex_granarius	Soricidae
sorex_araneus	Soricidae
sorex_antinorii	Soricidae
sorex_coronatus	Soricidae
sorex_daphaenodon	Soricidae
sorex_tundrensis	Soricidae
sorex_asper	Soricidae
sorex_arcticus	Soricidae
sorex_maritimensis	Soricidae
sorex_samniticus	Soricidae
sorex_roboratus	Soricidae
sorex_raddei	Soricidae
sorex_shinto	Soricidae
sorex_caecutiens	Soricidae
sorex_unguiculatus	Soricidae
sorex_isodon	Soricidae
sorex_minutissimus	Soricidae
sorex_yukonicus	Soricidae
sorex_hosonoi	Soricidae
sorex_gracillimus	Soricidae
sorex_minutus	Soricidae
sorex_volnuchini	Soricidae
sorex_mirabilis	Soricidae
sorex_excelsus	Soricidae
sorex_bedfordiae	Soricidae
sorex_cylindricauda	Soricidae
sorex_alpinus	Soricidae
cryptotis_obscura	Soricidae
cryptotis_mexicana	Soricidae
cryptotis_nelsoni	Soricidae
cryptotis_phillipsii	Soricidae
cryptotis_magna	Soricidae
cryptotis_mayensis	Soricidae
cryptotis_goldmani	Soricidae
cryptotis_peregrina	Soricidae
cryptotis_alticola	Soricidae
cryptotis_parva	Soricidae
blarina_hylophaga	Soricidae
blarina_carolinensis	Soricidae
blarina_brevicauda	Soricidae
blarinella_griselda	Soricidae
blarinella_quadraticauda	Soricidae
blarinella_wardi	Soricidae
chimarrogale_himalayica	Soricidae
chimarrogale_platycephala	Soricidae
chimarrogale_styani	Soricidae
chimarrogale_phaeura	Soricidae
nectogale_elegans	Soricidae
neomys_anomalus_milleri	Soricidae
neomys_teres	Soricidae
neomys_fodiens	Soricidae
episoriculus_caudatus_soluensis	Soricidae
episoriculus_leucops	Soricidae
episoriculus_macrurus	Soricidae
soriculus_nigrescens	Soricidae
episoriculus_fumidus	Soricidae
chodsigoa_caovansunga	Soricidae
chodsigoa_parca	Soricidae
chodsigoa_sodalis	Soricidae
chodsigoa_hypsibia	Soricidae
notiosorex_cockrumi	Soricidae
notiosorex_crawfordi	Soricidae
megasorex_gigas	Soricidae
anourosorex_squamipes	Soricidae
anourosorex_yamashinai	Soricidae
erinaceus_concolor	Erinaceidae
erinaceus_roumanicus	Erinaceidae
erinaceus_amurensis	Erinaceidae
erinaceus_europaeus	Erinaceidae
atelerix_algirus	Erinaceidae
atelerix_albiventris	Erinaceidae
atelerix_frontalis	Erinaceidae
mesechinus_dauuricus	Erinaceidae
mesechinus_hughi	Erinaceidae
hemiechinus_auritus	Erinaceidae
paraechinus_hypomelas	Erinaceidae
paraechinus_aethiopicus	Erinaceidae
hylomys_suillus_siamensis	Erinaceidae
hylomys_parvus	Erinaceidae
neotetracus_sinensis	Erinaceidae
neohylomys_hainanensis	Erinaceidae
echinosorex_gymnura	Erinaceidae
podogymnura_truei	Erinaceidae
hylomys_megalotis	Erinaceidae
euroscaptor_subanura	Talpidae
euroscaptor_parvidens	Talpidae
parascaptor_leucura	Talpidae
scaptochirus_moschatus	Talpidae
euroscaptor_longirostris	Talpidae
euroscaptor_malayana	Talpidae
euroscaptor_klossi	Talpidae
mogera_robusta	Talpidae
mogera_wogura	Talpidae
mogera_imaizumii	Talpidae
mogera_tokudae	Talpidae
mogera_insularis	Talpidae
mogera_kanoana	Talpidae
euroscaptor_mizura	Talpidae
talpa_romana	Talpidae
talpa_caeca	Talpidae
talpa_occidentalis	Talpidae
talpa_europaea	Talpidae
talpa_stankovici	Talpidae
talpa_levantis	Talpidae
talpa_caucasica	Talpidae
talpa_davidiana	Talpidae
talpa_altaica	Talpidae
desmana_moschata	Talpidae
galemys_pyrenaicus	Talpidae
scaptonyx_fusicaudus	Talpidae
neurotrichus_gibbsii	Talpidae
dymecodon_pilirostris	Talpidae
urotrichus_talpoides	Talpidae
scapanus_orarius	Talpidae
scapanus_townsendii	Talpidae
scapanus_latimanus	Talpidae
scalopus_aquaticus	Talpidae
parascalops_breweri	Talpidae
scapanulus_oweni	Talpidae
condylura_cristata	Talpidae
uropsilus_nivatus	Talpidae
uropsilus_gracilis	Talpidae
uropsilus_aequodonenia	Talpidae
uropsilus_andersoni	Talpidae
uropsilus_atronates	Talpidae
uropsilus_soricipes	Talpidae
uropsilus_sp_4_ft_2015	Talpidae
uropsilus_investigator	Talpidae
solenodon_cubanus	Solenodontidae
solenodon_paradoxus	Solenodontidae
tupaia_picta	Tupaiidae
tupaia_montana	Tupaiidae
tupaia_splendidula	Tupaiidae
tupaia_tana	Tupaiidae
tupaia_minor	Tupaiidae
tupaia_moellendorffi	Tupaiidae
tupaia_palawanensis	Tupaiidae
tupaia_nicobarica	Tupaiidae
tupaia_javanica	Tupaiidae
anathana_ellioti	Tupaiidae
tupaia_gracilis	Tupaiidae
tupaia_dorsalis	Tupaiidae
urogale_everetti	Tupaiidae
tupaia_salatana	Tupaiidae
tupaia_longipes	Tupaiidae
tupaia_chrysogaster	Tupaiidae
tupaia_chinensis	Tupaiidae
tupaia_belangeri	Tupaiidae
tupaia_glis	Tupaiidae
dendrogale_melanura	Tupaiidae
dendrogale_murina	Tupaiidae
ptilocercus_lowii	Tupaiidae
lepus_granatensis	Leporidae
lepus_arcticus	Leporidae
lepus_othus	Leporidae
lepus_timidus	Leporidae
lepus_coreanus	Leporidae
lepus_tolai	Leporidae
lepus_capensis	Leporidae
lepus_oiostolus_qinghaiensis	Leporidae
lepus_castroviejoi	Leporidae
lepus_corsicanus	Leporidae
lepus_townsendii	Leporidae
lepus_yarkandensis	Leporidae
lepus_sinensis	Leporidae
lepus_mandshuricus	Leporidae
lepus_comus	Leporidae
lepus_insularis	Leporidae
lepus_californicus_xanti	Leporidae
lepus_alleni	Leporidae
lepus_callotis	Leporidae
lepus_flavigularis	Leporidae
lepus_americanus	Leporidae
lepus_saxatilis	Leporidae
lepus_brachyurus	Leporidae
lepus_peguensis	Leporidae
lepus_hainanus	Leporidae
lepus_europaeus	Leporidae
sylvilagus_aquaticus	Leporidae
sylvilagus_palustris	Leporidae
sylvilagus_nuttallii	Leporidae
sylvilagus_audubonii	Leporidae
sylvilagus_obscurus	Leporidae
sylvilagus_transitionalis	Leporidae
sylvilagus_floridanus	Leporidae
sylvilagus_brasiliensis	Leporidae
nesolagus_timinsi	Leporidae
nesolagus_netscheri	Leporidae
pentalagus_furnessi	Leporidae
bunolagus_monticularis	Leporidae
romerolagus_diazi	Leporidae
brachylagus_idahoensis	Leporidae
pronolagus_rupestris	Leporidae
pronolagus_saundersiae	Leporidae
pronolagus_randensis	Leporidae
pronolagus_crassicaudatus	Leporidae
caprolagus_hispidus	Leporidae
oryctolagus_cuniculus_algirus	Leporidae
ochotona_annectens	Ochotonidae
ochotona_cansus_morosa	Ochotonidae
ochotona_nubrica	Ochotonidae
ochotona_curzoniae	Ochotonidae
ochotona_thibetana_nangqenica	Ochotonidae
ochotona_dauurica_bedfordi	Ochotonidae
ochotona_thomasi	Ochotonidae
ochotona_huangensis	Ochotonidae
ochotona_ladacensis	Ochotonidae
ochotona_koslowi	Ochotonidae
ochotona_roylei	Ochotonidae
ochotona_macrotis	Ochotonidae
ochotona_rutila	Ochotonidae
ochotona_himalayana	Ochotonidae
ochotona_rufescens	Ochotonidae
ochotona_erythrotis	Ochotonidae
ochotona_forresti	Ochotonidae
ochotona_pusilla	Ochotonidae
ochotona_scorodumovi	Ochotonidae
ochotona_mantchurica	Ochotonidae
ochotona_hyperborea	Ochotonidae
ochotona_hoffmanni	Ochotonidae
ochotona_alpina	Ochotonidae
ochotona_turuchanensis	Ochotonidae
ochotona_pallasi_pricei	Ochotonidae
ochotona_princeps	Ochotonidae
ochotona_collaris	Ochotonidae
urocitellus_parryii_ablusus	Sciuridae
urocitellus_richardsonii	Sciuridae
urocitellus_elegans_elegans	Sciuridae
urocitellus_columbianus_ruficaudus	Sciuridae
urocitellus_undulatus	Sciuridae
urocitellus_mollis	Sciuridae
urocitellus_townsendi_vigilis	Sciuridae
urocitellus_brunneus_brunneus	Sciuridae
urocitellus_washingtoni	Sciuridae
urocitellus_armatus	Sciuridae
urocitellus_beldingi_creber	Sciuridae
xerospermophilus_perotensis	Sciuridae
xerospermophilus_spilosoma	Sciuridae
xerospermophilus_tereticaudus	Sciuridae
xerospermophilus_mohavensis	Sciuridae
cynomys_gunnisoni	Sciuridae
cynomys_leucurus	Sciuridae
cynomys_parvidens	Sciuridae
cynomys_mexicanus	Sciuridae
cynomys_ludovicianus	Sciuridae
poliocitellus_franklinii	Sciuridae
ictidomys_tridecemlineatus	Sciuridae
ictidomys_parvidens	Sciuridae
ictidomys_mexicanus_mexicanus	Sciuridae
spermophilus_pallidicauda	Sciuridae
spermophilus_alashanicus	Sciuridae
spermophilus_relictus	Sciuridae
spermophilus_major	Sciuridae
spermophilus_fulvus	Sciuridae
spermophilus_erythrogenys	Sciuridae
spermophilus_pygmaeus	Sciuridae
spermophilus_musicus	Sciuridae
spermophilus_taurensis	Sciuridae
spermophilus_citellus	Sciuridae
spermophilus_suslicus	Sciuridae
spermophilus_xanthoprymnus	Sciuridae
marmota_caligata	Sciuridae
marmota_vancouverensis	Sciuridae
marmota_olympus	Sciuridae
marmota_flaviventris	Sciuridae
marmota_caudata	Sciuridae
marmota_menzbieri	Sciuridae
marmota_broweri	Sciuridae
marmota_sibirica	Sciuridae
marmota_camtschatica	Sciuridae
marmota_himalayana	Sciuridae
marmota_baibacina	Sciuridae
marmota_bobak	Sciuridae
marmota_marmota	Sciuridae
marmota_monax	Sciuridae
otospermophilus_beecheyi_nudipes	Sciuridae
otospermophilus_atricapillus	Sciuridae
otospermophilus_variegatus_utah	Sciuridae
callospermophilus_lateralis	Sciuridae
callospermophilus_madrensis	Sciuridae
callospermophilus_saturatus	Sciuridae
ammospermophilus_insularis	Sciuridae
ammospermophilus_leucurus	Sciuridae
ammospermophilus_interpres	Sciuridae
ammospermophilus_harrisii	Sciuridae
notocitellus_adocetus	Sciuridae
notocitellus_annulatus	Sciuridae
tamias_palmeri	Sciuridae
tamias_dorsalis	Sciuridae
tamias_cinereicollis	Sciuridae
tamias_umbrinus	Sciuridae
tamias_quadrivittatus	Sciuridae
tamias_rufus	Sciuridae
tamias_bulleri	Sciuridae
tamias_canipes	Sciuridae
tamias_durangae	Sciuridae
tamias_merriami	Sciuridae
tamias_obscurus	Sciuridae
tamias_alpinus	Sciuridae
tamias_minimus_scrutator	Sciuridae
tamias_panamintinus	Sciuridae
tamias_quadrimaculatus	Sciuridae
tamias_speciosus	Sciuridae
tamias_ruficaudus	Sciuridae
tamias_amoenus	Sciuridae
tamias_siskiyou	Sciuridae
tamias_sonomae	Sciuridae
tamias_senex	Sciuridae
tamias_ochrogenys	Sciuridae
tamias_townsendii	Sciuridae
tamias_striatus	Sciuridae
tamias_sibiricus	Sciuridae
paraxerus_vexillarius	Sciuridae
paraxerus_ochraceus	Sciuridae
funisciurus	Sciuridae
paraxerus_alexandri	Sciuridae
paraxerus_cepapi	Sciuridae
myosciurus_pumilio	Sciuridae
protoxerus_stangeri	Sciuridae
epixerus_wilsoni	Sciuridae
heliosciurus_ruwenzorii	Sciuridae
heliosciurus_undulatus	Sciuridae
sciurotamias_davidianus	Sciuridae
xerus_princeps	Sciuridae
xerus_inauris	Sciuridae
xerus_rutilus	Sciuridae
atlantoxerus_getulus	Sciuridae
spermophilopsis_leptodactylus	Sciuridae
petaurista_alborufus_castaneus	Sciuridae
petaurista_hainana	Sciuridae
petaurista_philippensis	Sciuridae
petaurista_yunanensis	Sciuridae
petaurista_albiventer	Sciuridae
petaurista_elegans	Sciuridae
petaurista_petaurista	Sciuridae
petaurista_xanthotis	Sciuridae
petaurista_leucogenys_nikkonis	Sciuridae
trogopterus_xanthipes	Sciuridae
belomys_pearsonii	Sciuridae
aeretes_melanopterus	Sciuridae
pteromyscus_pulverulentus	Sciuridae
eupetaurus_cinereus	Sciuridae
aeromys_tephromelas	Sciuridae
pteromys_momonga	Sciuridae
pteromys_volans	Sciuridae
hylopetes_phayrei	Sciuridae
hylopetes_alboniger	Sciuridae
petaurillus_kinlochii	Sciuridae
petinomys_setosus	Sciuridae
iomys_horsfieldi	Sciuridae
hylopetes_spadiceus	Sciuridae
hylopetes_lepidus	Sciuridae
hylopetes_nigripes	Sciuridae
glaucomys_volans	Sciuridae
glaucomys_sabrinus_griseifrons	Sciuridae
eoglaucomys_fimbriatus	Sciuridae
sciurus_colliaei	Sciuridae
sciurus_granatensis_hoffmanni	Sciuridae
sciurus_variegatoides_rigidus	Sciuridae
sciurus_deppei	Sciuridae
microsciurus_alfari	Sciuridae
syntheosciurus_brochus	Sciuridae
sciurus_aureogaster	Sciuridae
sciurus_oculatus	Sciuridae
sciurus_igniventris	Sciuridae
sciurus_pyrrhinus	Sciuridae
sciurus_stramineus	Sciuridae
microsciurus_flaviventer	Sciuridae
sciurus_aestuans	Sciuridae
sciurus_gilvigularis	Sciuridae
sciurus_ignitus	Sciuridae
sciurus_spadiceus	Sciuridae
sciurus_aberti	Sciuridae
sciurus_carolinensis	Sciuridae
sciurus_niger	Sciuridae
sciurus_anomalus	Sciuridae
sciurus_vulgaris	Sciuridae
sciurus_lis	Sciuridae
rheithrosciurus_macrotis	Sciuridae
sciurus_griseus	Sciuridae
tamiasciurus_hudsonicus	Sciuridae
tamiasciurus_douglasii	Sciuridae
sundasciurus_juvencus	Sciuridae
sundasciurus_moellendorffi	Sciuridae
sundasciurus_hoogstraali	Sciuridae
sundasciurus_steerii	Sciuridae
sundasciurus_rabori	Sciuridae
sundasciurus_philippinensis	Sciuridae
sundasciurus_mindanensis	Sciuridae
sundasciurus_samarensis	Sciuridae
sundasciurus_hippurus	Sciuridae
sundasciurus_tenuis	Sciuridae
sundasciurus_jentinki	Sciuridae
sundasciurus_tahan	Sciuridae
sundasciurus_fraterculus	Sciuridae
sundasciurus_brookei	Sciuridae
sundasciurus_lowii	Sciuridae
callosciurus_erythraeus	Sciuridae
callosciurus_finlaysonii	Sciuridae
callosciurus_inornatus	Sciuridae
callosciurus_caniceps	Sciuridae
callosciurus_nigrovittatus	Sciuridae
callosciurus_prevostii	Sciuridae
callosciurus_notatus	Sciuridae
dremomys_pyrrhomerus	Sciuridae
dremomys_rufigenis	Sciuridae
dremomys_gularis	Sciuridae
dremomys_pernyi	Sciuridae
dremomys_lokriah	Sciuridae
tamiops_swinhoei	Sciuridae
tamiops_maritimus	Sciuridae
tamiops_mcclellandii	Sciuridae
tamiops_rodolphii	Sciuridae
menetes_berdmorei	Sciuridae
rhinosciurus_laticaudatus	Sciuridae
lariscus_insignis	Sciuridae
nannosciurus_melanotis	Sciuridae
prosciurillus_murinus	Sciuridae
rubrisciurus_rubriventer	Sciuridae
hyosciurus_heinrichi	Sciuridae
exilisciurus_exilis	Sciuridae
exilisciurus_concinnus	Sciuridae
funambulus_sublineatus	Sciuridae
funambulus_pennantii	Sciuridae
funambulus_palmarum	Sciuridae
funambulus_layardi	Sciuridae
sciurillus_pusillus	Sciuridae
ratufa_affinis	Sciuridae
ratufa_bicolor	Sciuridae
aplodontia_rufa_nigra	Aplodontiidae
graphiurus_murinus	Gliridae
graphiurus_microtis	Gliridae
graphiurus_parvus	Gliridae
graphiurus_lorraineus	Gliridae
graphiurus_kelleni	Gliridae
graphiurus_ocularis	Gliridae
graphiurus_platyops	Gliridae
myomimus_roachi	Gliridae
muscardinus_avellanarius	Gliridae
glirulus_japonicus	Gliridae
glis_glis	Gliridae
dryomys_nitedula	Gliridae
dryomys_laniger	Gliridae
eliomys_melanurus	Gliridae
eliomys_quercinus	Gliridae
phyllomys_aff_dasythrix	Echimyidae
phyllomys_sulinus	Echimyidae
phyllomys_dasythrix	Echimyidae
phyllomys_lundi	Echimyidae
phyllomys_nigrispinus	Echimyidae
phyllomys_blainvillii	Echimyidae
phyllomys_brasiliensis	Echimyidae
phyllomys_lamarum	Echimyidae
phyllomys_unicolor	Echimyidae
phyllomys_mantiqueirensis	Echimyidae
phyllomys_pattoni	Echimyidae
echimys_chrysurus	Echimyidae
makalata_macrura	Echimyidae
makalata_didelphoides	Echimyidae
toromys_grandis	Echimyidae
toromys_rhipidurus	Echimyidae
pattonomys_occasius	Echimyidae
pattonomys_semivillosus	Echimyidae
dactylomys_dactylinus	Echimyidae
dactylomys_boliviensis	Echimyidae
kannabateomys_amblyonyx	Echimyidae
olallamys_albicauda	Echimyidae
santamartamys_rufodorsalis	Echimyidae
diplomys_labilis	Echimyidae
mesomys_stimulax	Echimyidae
mesomys_hispidus	Echimyidae
mesomys_occultus	Echimyidae
lonchothrix_emiliae	Echimyidae
isothrix_sinnamariensis	Echimyidae
isothrix_pagurus	Echimyidae
isothrix_barbarabrownae	Echimyidae
isothrix_bistriata	Echimyidae
isothrix_orinoci	Echimyidae
proechimys_cuvieri	Echimyidae
proechimys_longicaudatus	Echimyidae
proechimys_roberti	Echimyidae
proechimys_oris	Echimyidae
proechimys_quadruplicatus	Echimyidae
proechimys_simonsi	Echimyidae
proechimys_guyannensis	Echimyidae
hoplomys_gymnurus	Echimyidae
callistomys_pictus	Echimyidae
myocastor_coypus	Myocastoridae
thrichomys_laurenteus	Echimyidae
thrichomys_apereoides_apereoides	Echimyidae
thrichomys_aff_apereoides	Echimyidae
thrichomys_pachyurus	Echimyidae
thrichomys_fosteri	Echimyidae
thrichomys_inermis	Echimyidae
trinomys_eliasi	Echimyidae
trinomys_paratus	Echimyidae
trinomys_yonenagae	Echimyidae
trinomys_setosus_elegans	Echimyidae
trinomys_dimidiatus	Echimyidae
trinomys_gratiosus	Echimyidae
trinomys_moojeni	Echimyidae
trinomys_iheringi	Echimyidae
trinomys_albispinus	Echimyidae
euryzygomatomys_spinosus	Echimyidae
clyomys_laticeps	Echimyidae
mesocapromys_melanurus	Capromyidae
mesocapromys_auritus	Capromyidae
mesocapromys_angelcabrerai	Capromyidae
mysateles_prehensilis	Capromyidae
capromys_pilorides	Capromyidae
geocapromys_ingrahami	Capromyidae
geocapromys_brownii	Capromyidae
plagiodontia_aedium	Capromyidae
carterodon_sulcidens	Echimyidae
ctenomys_perrensi	Ctenomyidae
ctenomys_roigi	Ctenomyidae
ctenomys_pearsoni	Ctenomyidae
ctenomys_dorbignyi	Ctenomyidae
ctenomys_lami	Ctenomyidae
ctenomys_torquatus	Ctenomyidae
ctenomys_minutus	Ctenomyidae
ctenomys_porteousi	Ctenomyidae
ctenomys_australis	Ctenomyidae
ctenomys_flamarioni	Ctenomyidae
ctenomys_mendocinus	Ctenomyidae
ctenomys_rionegrensis	Ctenomyidae
ctenomys_pundti	Ctenomyidae
ctenomys_talarum	Ctenomyidae
ctenomys_frater	Ctenomyidae
ctenomys_lewisi	Ctenomyidae
ctenomys_conoveri	Ctenomyidae
ctenomys_sociabilis	Ctenomyidae
ctenomys_tuconax	Ctenomyidae
ctenomys_leucodon	Ctenomyidae
ctenomys_sericeus	Ctenomyidae
ctenomys_fodax	Ctenomyidae
ctenomys_coyhaiquensis	Ctenomyidae
ctenomys_haigi	Ctenomyidae
ctenomys_colburni	Ctenomyidae
ctenomys_magellanicus	Ctenomyidae
ctenomys_occultus	Ctenomyidae
ctenomys_argentinus	Ctenomyidae
ctenomys_latro	Ctenomyidae
ctenomys_tucumanus	Ctenomyidae
ctenomys_opimus	Ctenomyidae
ctenomys_fulvus	Ctenomyidae
ctenomys_scagliai	Ctenomyidae
ctenomys_saltarius	Ctenomyidae
ctenomys_maulinus	Ctenomyidae
ctenomys_boliviensis	Ctenomyidae
ctenomys_goodfellowi	Ctenomyidae
ctenomys_nattereri	Ctenomyidae
ctenomys_steinbachi	Ctenomyidae
ctenomys_erikacuellarae	Ctenomyidae
aconaemys_sagei	Octodontidae
aconaemys_fuscus	Octodontidae
aconaemys_porteri	Octodontidae
spalacopus_cyanus	Octodontidae
octodon_lunatus	Octodontidae
octodon_bridgesi	Octodontidae
octodon_degus	Octodontidae
octodontomys_gliroides	Ctenomyidae
tympanoctomys_loschalchalerosorum	Octodontidae
tympanoctomys_barrerae	Octodontidae
pipanacoctomys_aureus	Octodontidae
octomys_mimax	Octodontidae
cuscomys_ashaninka	Abrocomidae
abrocoma_cinerea	Abrocomidae
abrocoma_bennettii	Abrocomidae
lagidium_viscacia	Chinchillidae
chinchilla_lanigera	Chinchillidae
lagostomus_maximus	Chinchillidae
dinomys_branickii	Dinomyidae
coendou_quichua	Erethizontidae
coendou_rufescens	Erethizontidae
coendou_mexicanus	Erethizontidae
coendou_bicolor	Erethizontidae
coendou_prehensilis	Erethizontidae
coendou_insidiosus	Erethizontidae
coendou_villosus	Erethizontidae
coendou_spinosus	Erethizontidae
coendou_melanurus	Erethizontidae
coendou_ichillus	Erethizontidae
erethizon_dorsatum	Erethizontidae
chaetomys_subspinosus	Erethizontidae
cavia_aperea_guianae	Caviidae
cavia_fulgida	Caviidae
cavia_tschudii	Caviidae
cavia_porcellus	Caviidae
cavia_cutleri	Caviidae
cavia_magna	Caviidae
microcavia	Caviidae
kerodon_acrobata	Caviidae
kerodon_rupestris	Caviidae
hydrochoerus_hydrochaeris	Hydrochaeridae
dolichotis_patagonum_centricola	Caviidae
dolichotis_salinicola	Caviidae
galea_musteloides_leucoblephara	Caviidae
galea_spixii	Caviidae
dasyprocta_fuliginosa	Dasyproctidae
dasyprocta_leporina	Dasyproctidae
dasyprocta_punctata	Dasyproctidae
myoprocta_acouchy	Dasyproctidae
myoprocta_pratti	Dasyproctidae
cuniculus_paca	Cuniculidae
cuniculus_taczanowskii	Cuniculidae
fukomys_kafuensis	Bathyergidae
fukomys_choma	Bathyergidae
fukomys_micklemi	Bathyergidae
fukomys_anselli	Bathyergidae
fukomys_darlingi	Bathyergidae
fukomys_whytei_occlusus	Bathyergidae
fukomys_amatus	Bathyergidae
fukomys_bocagei	Bathyergidae
fukomys_mechowii	Bathyergidae
fukomys_ochraceocinereus	Bathyergidae
fukomys_foxi	Bathyergidae
fukomys_damarensis	Bathyergidae
cryptomys_hottentotus_anomalus	Bathyergidae
bathyergus_suillus	Bathyergidae
bathyergus_janetta	Bathyergidae
georychus_capensis	Bathyergidae
heliophobius_argenteocinereus	Bathyergidae
heterocephalus_glaber	Bathyergidae
thryonomys_swinderianus	Thryonomyidae
petromus_typicus	Petromuridae
hystrix_cristata	Hystricidae
hystrix_africaeaustralis	Hystricidae
hystrix_brachyura	Hystricidae
atherurus_africanus	Hystricidae
atherurus_macrourus	Hystricidae
trichys_fasciculata	Hystricidae
ctenodactylus_vali	Ctenodactylidae
ctenodactylus_gundi	Ctenodactylidae
massoutiera_mzabi	Ctenodactylidae
laonastes_aenigmamus	Laonastidae
peromyscus_boylii_rowleyi	Cricetidae
peromyscus_simulus	Cricetidae
peromyscus_stephani	Cricetidae
peromyscus_levipes_ambiguus	Cricetidae
peromyscus_schmidlyi	Cricetidae
peromyscus_beatae_sacarensis	Cricetidae
peromyscus_aztecus_evides	Cricetidae
peromyscus_hylocetes	Cricetidae
peromyscus_crinitus_stephensi	Cricetidae
peromyscus_spicilegus	Cricetidae
peromyscus_winkelmanni	Cricetidae
peromyscus_truei_montipinoris	Cricetidae
peromyscus_gratus_gentilis	Cricetidae
peromyscus_difficilis_saxicola	Cricetidae
peromyscus_nasutus	Cricetidae
peromyscus_attwateri	Cricetidae
peromyscus_ochraventer	Cricetidae
peromyscus_pectoralis_laceianus	Cricetidae
peromyscus_guatemalensis	Cricetidae
peromyscus_grandis	Cricetidae
peromyscus_salvadorensis	Cricetidae
peromyscus_nicaraguae	Cricetidae
peromyscus_furvus	Cricetidae
peromyscus_zarhynchus	Cricetidae
peromyscus_tropicalis	Cricetidae
peromyscus_nudipes	Cricetidae
peromyscus_mexicanus	Cricetidae
peromyscus_gymnotis	Cricetidae
peromyscus_melanophrys	Cricetidae
peromyscus_perfulvus	Cricetidae
peromyscus_melanocarpus	Cricetidae
peromyscus_mayensis	Cricetidae
peromyscus_megalops	Cricetidae
peromyscus_stirtoni	Cricetidae
habromys_lepturus	Cricetidae
habromys_ixtlani	Cricetidae
habromys_lophurus	Cricetidae
habromys_delicatulus	Cricetidae
habromys_simulatus	Cricetidae
habromys_chinanteco	Cricetidae
neotomodon_alstoni	Cricetidae
peromyscus_polionotus_peninsularis	Cricetidae
peromyscus_maniculatus	Cricetidae
peromyscus_sejugis	Cricetidae
peromyscus_keeni	Cricetidae
peromyscus_melanotis	Cricetidae
peromyscus_leucopus	Cricetidae
peromyscus_gossypinus	Cricetidae
peromyscus_hooperi	Cricetidae
peromyscus_yucatanicus	Cricetidae
peromyscus_collatus	Cricetidae
peromyscus_eremicus	Cricetidae
peromyscus_interparietalis	Cricetidae
peromyscus_dickeyi	Cricetidae
peromyscus_merriami	Cricetidae
peromyscus_caniceps	Cricetidae
peromyscus_fraterculus	Cricetidae
peromyscus_slevini	Cricetidae
peromyscus_eva	Cricetidae
peromyscus_californicus_insignis	Cricetidae
osgoodomys_banderanus	Cricetidae
podomys_floridanus	Cricetidae
megadontomys_nelsoni	Cricetidae
megadontomys_thomasi	Cricetidae
megadontomys_cryophilus	Cricetidae
onychomys_leucogaster	Cricetidae
onychomys_arenicola	Cricetidae
onychomys_torridus	Cricetidae
reithrodontomys_sumichrasti	Cricetidae
reithrodontomys_brevirostris	Cricetidae
reithrodontomys_dariensis	Cricetidae
reithrodontomys_gracilis	Cricetidae
reithrodontomys_spectabilis	Cricetidae
reithrodontomys_mexicanus	Cricetidae
reithrodontomys_microdon	Cricetidae
reithrodontomys_bakeri	Cricetidae
reithrodontomys_tenuirostris	Cricetidae
reithrodontomys_creper	Cricetidae
reithrodontomys_chrysopsis	Cricetidae
reithrodontomys_humulis	Cricetidae
reithrodontomys_megalotis	Cricetidae
reithrodontomys_zacatecae	Cricetidae
reithrodontomys_raviventris	Cricetidae
reithrodontomys_montanus	Cricetidae
reithrodontomys_hirsutus	Cricetidae
reithrodontomys_fulvescens	Cricetidae
isthmomys_pirrensis	Cricetidae
baiomys_taylori	Cricetidae
baiomys_musculus	Cricetidae
scotinomys_xerampelinus	Cricetidae
scotinomys_teguina	Cricetidae
ochrotomys_nuttalli_aureolus	Cricetidae
neotoma_albigula_seri	Cricetidae
neotoma_nelsoni	Cricetidae
neotoma_floridana	Cricetidae
neotoma_magister	Cricetidae
neotoma_micropus	Cricetidae
neotoma_goldmani	Cricetidae
neotoma_leucodon	Cricetidae
neotoma_ferruginea_vulcani	Cricetidae
neotoma_isthmica	Cricetidae
neotoma_picta	Cricetidae
neotoma_mexicana_distincta	Cricetidae
neotoma_stephensi	Cricetidae
neotoma_devia	Cricetidae
neotoma_lepida	Cricetidae
neotoma_bryanti	Cricetidae
neotoma_macrotis	Cricetidae
neotoma_fuscipes	Cricetidae
neotoma_cinerea	Cricetidae
xenomys_nelsoni	Cricetidae
hodomys_alleni	Cricetidae
nyctomys_sumichrasti_florencei	Cricetidae
otonyctomys_hatti	Cricetidae
tylomys_nudicaudus	Cricetidae
tylomys_watsoni	Cricetidae
ototylomys_phyllotis	Cricetidae
microtus_liechtensteini	Cricetidae
microtus_bavaricus	Cricetidae
microtus_multiplex	Cricetidae
microtus_tatricus	Cricetidae
microtus_thomasi	Cricetidae
microtus_felteni	Cricetidae
microtus_savii	Cricetidae
microtus_duodecimcostatus	Cricetidae
microtus_lusitanicus	Cricetidae
microtus_gerbei	Cricetidae
microtus_pyrenaicus	Cricetidae
microtus_daghestanicus	Cricetidae
microtus_majori	Cricetidae
microtus_subterraneus	Cricetidae
microtus_guentheri	Cricetidae
microtus_dogramacii	Cricetidae
microtus_socialis	Cricetidae
microtus_anatolicus	Cricetidae
microtus_irani	Cricetidae
microtus_paradoxus	Cricetidae
microtus_schelkovnikovi	Cricetidae
microtus_obscurus	Cricetidae
microtus_arvalis	Cricetidae
microtus_levis	Cricetidae
microtus_kirgisorum	Cricetidae
microtus_transcaspicus	Cricetidae
microtus_abbreviatus	Cricetidae
microtus_miurus	Cricetidae
microtus_quasiater	Cricetidae
microtus_pinetorum	Cricetidae
microtus_oaxacensis	Cricetidae
microtus_chrotorrhinus	Cricetidae
microtus_umbrosus	Cricetidae
microtus_richardsoni	Cricetidae
microtus_guatemalensis	Cricetidae
microtus_cabrerae	Cricetidae
microtus_mexicanus	Cricetidae
microtus_californicus	Cricetidae
microtus_xanthognathus	Cricetidae
microtus_ochrogaster	Cricetidae
microtus_montanus	Cricetidae
microtus_pennsylvanicus	Cricetidae
microtus_townsendii	Cricetidae
microtus_canicaudus	Cricetidae
microtus_longicaudus	Cricetidae
microtus_oregoni	Cricetidae
neodon_juldaschi_carruthersi	Cricetidae
blanfordimys_bucharensis	Cricetidae
blanfordimys_afghanus	Cricetidae
microtus_agrestis	Cricetidae
microtus_maximowiczii	Cricetidae
microtus_middendorffii	Cricetidae
microtus_mongolicus	Cricetidae
microtus_sachalinensis	Cricetidae
microtus_fortis_fortis	Cricetidae
microtus_limnophilus	Cricetidae
microtus_montebelli	Cricetidae
microtus_oeconomus	Cricetidae
microtus_kikuchii	Cricetidae
lasiopodomys_mandarinus	Cricetidae
lasiopodomys_brandtii	Cricetidae
neodon_leucurus	Cricetidae
neodon_fuscus	Cricetidae
neodon_irene	Cricetidae
neodon_clarkei	Cricetidae
volemys_millicens	Cricetidae
neodon_sikimensis	Cricetidae
proedromys_liangshanensis	Cricetidae
microtus_gregalis	Cricetidae
proedromys_bedfordi	Cricetidae
volemys_musseri	Cricetidae
chionomys_gud	Cricetidae
chionomys_roberti	Cricetidae
chionomys_nivalis	Cricetidae
eolagurus_luteus	Cricetidae
lagurus_lagurus	Cricetidae
arvicola_scherman	Cricetidae
arvicola_amphibius	Cricetidae
arvicola_sapidus	Cricetidae
dinaromys_bogdanovi	Cricetidae
ellobius_talpinus	Cricetidae
ellobius_tancrei	Cricetidae
ellobius_fuscocapillus	Cricetidae
alticola_strelzowi	Cricetidae
alticola_semicanus	Cricetidae
alticola_tuvinicus	Cricetidae
alticola_olchonensis	Cricetidae
alticola_barakshin	Cricetidae
alticola_argentatus	Cricetidae
alticola_albicaudus	Cricetidae
alticola_montosa	Cricetidae
myodes_rutilus	Cricetidae
myodes_californicus	Cricetidae
myodes_gapperi	Cricetidae
alticola_macrotis	Cricetidae
alticola_lemminus	Cricetidae
myodes_glareolus	Cricetidae
myodes_rufocanus_bedfordiae	Cricetidae
myodes_regulus	Cricetidae
myodes_rex	Cricetidae
myodes_smithii	Cricetidae
myodes_andersoni	Cricetidae
myodes_centralis	Cricetidae
eothenomys_olitor	Cricetidae
eothenomys_proditor	Cricetidae
eothenomys_chinensis	Cricetidae
eothenomys_wardi	Cricetidae
eothenomys_custos	Cricetidae
eothenomys_miletus	Cricetidae
eothenomys_cachinus	Cricetidae
eothenomys_eleusis	Cricetidae
eothenomys_melanogaster	Cricetidae
eothenomys_inez	Cricetidae
eothenomys_eva	Cricetidae
ondatra_zibethicus	Cricetidae
neofiber_alleni	Cricetidae
dicrostonyx_groenlandicus	Cricetidae
dicrostonyx_richardsoni	Cricetidae
dicrostonyx_hudsonius	Cricetidae
dicrostonyx_torquatus	Cricetidae
phenacomys_intermedius	Cricetidae
prometheomys_schaposchnikowi	Cricetidae
lemmus_lemmus	Cricetidae
lemmus_sibiricus	Cricetidae
lemmus_trimucronatus	Cricetidae
synaptomys_cooperi	Cricetidae
synaptomys_borealis	Cricetidae
cricetulus_griseus	Cricetidae
cricetulus_barabensis	Cricetidae
cricetulus_sokolovi	Cricetidae
cricetulus_longicaudatus	Cricetidae
cricetulus_migratorius	Cricetidae
cricetus_cricetus	Cricetidae
allocricetulus_eversmanni	Cricetidae
tscherskia_triton	Cricetidae
mesocricetus_raddei	Cricetidae
mesocricetus_auratus	Cricetidae
mesocricetus_newtoni	Cricetidae
mesocricetus_brandti	Cricetidae
phodopus_sungorus	Cricetidae
phodopus_campbelli	Cricetidae
phodopus_roborovskii	Cricetidae
urocricetus_kamensis	Cricetidae
urocricetus_lama	Cricetidae
eliurus_webbi	Nesomyidae
eliurus_ellermani	Nesomyidae
eliurus_tanala	Nesomyidae
eliurus_myoxinus	Nesomyidae
eliurus_minor	Nesomyidae
eliurus_majori	Nesomyidae
eliurus_antsingy	Nesomyidae
eliurus_carletoni	Nesomyidae
eliurus_grandidieri	Nesomyidae
voalavo_gymnocaudus	Nesomyidae
gymnuromys_roberti	Nesomyidae
brachytarsomys_albicauda	Nesomyidae
nesomys_rufus	Nesomyidae
nesomys_audeberti	Nesomyidae
brachyuromys_ramirohitra	Nesomyidae
brachyuromys_betsileoensis	Nesomyidae
hypogeomys_antimena	Nesomyidae
monticolomys_koopmani	Nesomyidae
macrotarsomys	Nesomyidae
dendromus_nyasae_kivu	Nesomyidae
dendromus_insignis	Nesomyidae
dendromus_mesomelas	Nesomyidae
dendromus_mystacalis	Nesomyidae
dendromus_nyikae	Nesomyidae
dendromus_melanotis	Nesomyidae
steatomys_parvus	Nesomyidae
steatomys_krebsii	Nesomyidae
saccostomus_mearnsi	Nesomyidae
saccostomus_umbriventer	Nesomyidae
saccostomus_mashonae	Nesomyidae
saccostomus_campestris	Nesomyidae
cricetomys_ansorgei	Nesomyidae
cricetomys_gambianus	Nesomyidae
cricetomys_emini	Nesomyidae
beamys_hindei	Nesomyidae
delanymys_brooksi	Nesomyidae
acomys_minous	Muridae
acomys_cilicicus	Muridae
acomys_nesiotes	Muridae
acomys_chudeaui	Muridae
acomys_dimidiatus	Muridae
acomys_cahirinus	Muridae
acomys_johannis	Muridae
acomys_ignitus	Muridae
acomys_percivali	Muridae
acomys_wilsoni	Muridae
acomys_russatus	Muridae
acomys_spinosissimus	Muridae
acomys_ngurui	Muridae
lophuromys_zena	Muridae
lophuromys_flavopunctatus	Muridae
lophuromys_sikapusi	Muridae
deomys_ferrugineus	Muridae
uranomys_ruddi	Muridae
calomyscus_bailwardi	Calomyscidae
calomyscus_baluchi	Calomyscidae
calomyscus_hotsoni	Calomyscidae
hapalomys_delacouri	Muridae
praomys_petteri	Muridae
praomys_coetzeei	Muridae
praomys_hartwigi	Muridae
praomys_obscurus	Muridae
praomys_morio	Muridae
praomys_misonnei	Muridae
praomys_rostratus	Muridae
praomys_tullbergi	Muridae
praomys_daltoni	Muridae
praomys_derooi	Muridae
praomys_jacksoni	Muridae
praomys_minor	Muridae
praomys_mutoni	Muridae
praomys_degraaffi	Muridae
zelotomys_hildegardeae	Muridae
colomys_goslingi	Muridae
myomyscus_verreauxii	Muridae
mastomys_hildebrandtii	Muridae
mastomys_natalensis	Muridae
mastomys_erythroleucus	Muridae
mastomys_awashensis	Muridae
mastomys_huberti	Muridae
mastomys_coucha	Muridae
mastomys_kollmannspergeri	Muridae
mastomys_verheyeni	Muridae
stenocephalemys_griseicauda	Muridae
stenocephalemys_albipes	Muridae
stenocephalemys_albocaudata	Muridae
myomyscus_brockmani	Muridae
praomys_lukolelae	Muridae
praomys_verschureni	Muridae
hylomyscus_pamfi	Muridae
hylomyscus_simus	Muridae
hylomyscus_alleni	Muridae
hylomyscus_stella	Muridae
hylomyscus_walterverheyeni	Muridae
hylomyscus_parvus	Muridae
hylomyscus_kaimosae	Muridae
hylomyscus_arcimontensis	Muridae
hylomyscus_anselli	Muridae
hylomyscus_baeri	Muridae
hylomyscus_endorobae	Muridae
hylomyscus_vulcanorum	Muridae
hylomyscus_denniae	Muridae
hylomyscus_aeta	Muridae
hylomyscus_grandis	Muridae
heimyscus_fumosus	Muridae
praomys_taitae	Muridae
mastomys_pernanus	Muridae
praomys_delectorum	Muridae
mus_tenellus	Muridae
mus_minutoides	Muridae
mus_musculoides	Muridae
mus_indutus	Muridae
mus_haussa	Muridae
mus_mattheyi	Muridae
mus_sorella	Muridae
mus_neavei	Muridae
mus_baoulei	Muridae
mus_bufo	Muridae
mus_mahomet	Muridae
mus_setulosus	Muridae
mus_imberbis	Muridae
mus_triton	Muridae
mus_crociduroides	Muridae
mus_pahari	Muridae
mus_saxicola	Muridae
mus_platythrix	Muridae
mus_musculus_bactrianus	Muridae
mus_macedonicus	Muridae
mus_spicilegus	Muridae
mus_spretus	Muridae
mus_booduga	Muridae
mus_fragilicauda	Muridae
mus_famulus	Muridae
mus_terricolor	Muridae
mus_cervicolor	Muridae
mus_cookii	Muridae
mus_caroli	Muridae
apodemus_agrarius_coreae	Muridae
apodemus_chejuensis	Muridae
apodemus_chevrieri	Muridae
apodemus_peninsulae	Muridae
apodemus_ilex	Muridae
apodemus_draco	Muridae
apodemus_semotus	Muridae
apodemus_latronum	Muridae
apodemus_speciosus	Muridae
apodemus_gurkha	Muridae
apodemus_argenteus	Muridae
apodemus_uralensis	Muridae
apodemus_wardi	Muridae
apodemus_pallipes	Muridae
apodemus_alpicola	Muridae
apodemus_ponticus	Muridae
apodemus_flavicollis	Muridae
apodemus_sylvaticus	Muridae
apodemus_hermonensis	Muridae
apodemus_mystacinus	Muridae
tokudaia_tokunoshimensis	Muridae
tokudaia_osimensis	Muridae
tokudaia_muenninki	Muridae
malacomys_longipes	Muridae
malacomys_edwardsi	Muridae
lemniscomys_macculus	Muridae
lemniscomys_bellieri	Muridae
lemniscomys_rosalia	Muridae
lemniscomys_zebra	Muridae
lemniscomys_barbarus	Muridae
lemniscomys_striatus	Muridae
arvicanthis_dembeensis	Muridae
arvicanthis_niloticus	Muridae
arvicanthis_abyssinicus	Muridae
arvicanthis_somalicus	Muridae
pelomys_fallax	Muridae
pelomys_campanae	Muridae
mylomys_dybowskii	Muridae
rhabdomys_pumilio	Muridae
rhabdomys_dilectus	Muridae
lamottemys_okuensis	Muridae
desmomys_harringtoni	Muridae
dasymys_incomtus	Muridae
dasymys_rufulus	Muridae
thallomys_paedulcus	Muridae
grammomys_surdaster	Muridae
thallomys_nigricauda	Muridae
grammomys_macmillani	Muridae
thallomys_loringi	Muridae
grammomys_gazellae	Muridae
grammomys_dolichurus	Muridae
grammomys_ibeanus	Muridae
micaelamys_namaquensis	Muridae
dephomys_defua	Muridae
aethomys_chrysophilus	Muridae
aethomys_kaiseri	Muridae
stochomys_longicaudatus	Muridae
hybomys_univittatus	Muridae
oenomys_hypoxanthus	Muridae
otomys_jacksoni	Muridae
otomys_orestes	Muridae
otomys_tropicalis_faradjius	Muridae
otomys_dartmouthi	Muridae
otomys_zinki	Muridae
otomys_simiensis	Muridae
otomys_occidentalis	Muridae
otomys_typus_fortior	Muridae
otomys_maximus	Muridae
otomys_angoniensis	Muridae
otomys_saundersiae_karoensis	Muridae
otomys_laminatus	Muridae
otomys_irroratus	Muridae
myotomys_unisulcatus	Muridae
parotomys_littledalei	Muridae
myotomys_sloggetti	Muridae
parotomys_brantsii	Muridae
otomys_barbouri	Muridae
otomys_lacustris	Muridae
otomys_denti_sungae	Muridae
otomys_anchietae	Muridae
golunda_ellioti	Muridae
melomys_rufescens	Muridae
melomys_cervinipes	Muridae
solomys_salebrosus	Muridae
paramelomys_levipes	Muridae
uromys_caudimaculatus	Muridae
conilurus_penicillatus	Muridae
mesembriomys_gouldii	Muridae
leporillus_conditor	Muridae
mastacomys_fuscus	Muridae
pseudomys	Muridae
notomys	Muridae
leggadina_forresti	Muridae
leggadina_lakedownensis	Muridae
zyzomys_argurus	Muridae
parahydromys_asper	Muridae
hydromys_chrysogaster	Muridae
crossomys_moncktoni	Muridae
xeromys_myoides	Muridae
pseudohydromys_ellermani	Muridae
leptomys_elegans	Muridae
mammelomys_lanosus	Muridae
abeomelomys_sevia	Muridae
mallomys_rothschildi	Muridae
pogonomys_sylvestris	Muridae
pogonomys_macrourus	Muridae
pogonomys_loriae	Muridae
hyomys_goliath	Muridae
chiruromys_vates	Muridae
macruromys_major	Muridae
lorentzimys_nouhuysi	Muridae
anisomys_imitator	Muridae
apomys_lubangensis	Muridae
apomys_sacobianus	Muridae
apomys_abrae	Muridae
apomys_datae	Muridae
apomys_iridensis	Muridae
apomys_gracilirostris	Muridae
apomys_insignis	Muridae
apomys_hylocoetes	Muridae
apomys_camiguinensis	Muridae
apomys_musculus	Muridae
apomys_microdon	Muridae
chrotomys_mindorensis	Muridae
chrotomys_gonzalesi	Muridae
chrotomys_whiteheadi	Muridae
chrotomys_sibuyanensis	Muridae
chrotomys_silaceus	Muridae
rhynchomys_soricoides	Muridae
rhynchomys_tapulao	Muridae
rhynchomys_isarogensis	Muridae
rhynchomys_banahao	Muridae
archboldomys_luzonensis	Muridae
millardia_meltada	Muridae
millardia_kathleenae	Muridae
chiropodomys_gliroides	Muridae
rattus_steini	Muridae
rattus_novaeguineae	Muridae
rattus_giluwensis	Muridae
rattus_praetor	Muridae
rattus_niobe	Muridae
rattus_leucopus	Muridae
rattus_verecundus	Muridae
rattus_villosissimus	Muridae
rattus_colletti	Muridae
rattus_sordidus	Muridae
rattus_lutreolus	Muridae
rattus_tunneyi	Muridae
rattus_fuscipes	Muridae
rattus_morotaiensis	Muridae
bandicota_bengalensis	Muridae
bandicota_indica	Muridae
nesokia_indica	Muridae
bandicota_savilei	Muridae
diplothrix_legata	Muridae
limnomys_bryophilus	Muridae
limnomys_sibuanus	Muridae
tarsomys_apoensis	Muridae
rattus_everetti	Muridae
rattus_hoffmanni	Muridae
rattus_rattus	Muridae
rattus_tanezumi	Muridae
rattus_sakeratensis	Muridae
rattus_tiomanicus	Muridae
rattus_baluensis	Muridae
rattus_losea	Muridae
rattus_pyctoris	Muridae
rattus_argentiventer	Muridae
rattus_andamanensis	Muridae
rattus_exulans	Muridae
rattus_norvegicus	Muridae
rattus_nitidus	Muridae
rattus_satarae	Muridae
bullimus_gamay	Muridae
bullimus_bagobus	Muridae
bullimus_luzonicus	Muridae
halmaheramys_bokimekot	Muridae
sundamys_muelleri	Muridae
bunomys_andrewsi	Muridae
bunomys_chrysocomus	Muridae
bunomys_penitus	Muridae
taeromys_celebensis	Muridae
paruromys_dominator	Muridae
berylmys_berdmorei	Muridae
berylmys_bowersi	Muridae
srilankamys_ohiensis	Muridae
niviventer_coninga	Muridae
niviventer_eha	Muridae
niviventer_tenaster	Muridae
niviventer_bukit	Muridae
niviventer_confucianus	Muridae
niviventer_culturatus	Muridae
niviventer_andersoni	Muridae
niviventer_excelsior	Muridae
nivivneter_brahma	Muridae
niviventer_huang	Muridae
niviventer_niviventer	Muridae
niviventer_fulvescens	Muridae
niviventer_hinpoon	Muridae
niviventer_cremoriventer	Muridae
niviventer_rapit	Muridae
chiromyscus_chiropus	Muridae
chiromyscus_langbianis	Muridae
chiromyscus_thomasi	Muridae
leopoldamys_sabanus	Muridae
leopoldamys_revertens	Muridae
leopoldamys_milleti	Muridae
leopoldamys_edwardsi	Muridae
leopoldamys_neilli	Muridae
dacnomys_millardi	Muridae
margaretamys_elegans	Muridae
tonkinomys_daovantieni	Muridae
saxatilomys_paulinae	Muridae
paucidentomys_vermidax	Muridae
echiothrix_centrosa	Muridae
melasmothrix_naso	Muridae
crunomys_melanius	Muridae
crunomys_suncoides	Muridae
crunomys_celebensis	Muridae
maxomys_dollmani	Muridae
maxomys_hellwaldii	Muridae
maxomys_tajuddinii	Muridae
maxomys_hylomyoides	Muridae
maxomys_whiteheadi	Muridae
maxomys_musschenbroekii	Muridae
maxomys_moi	Muridae
maxomys_pagensis	Muridae
maxomys_rajah	Muridae
maxomys_surifer	Muridae
maxomys_bartelsii	Muridae
maxomys_panglima	Muridae
maxomys_ochraceiventer	Muridae
micromys_minutus	Muridae
vandeleuria_sp_kcr_2008	Muridae
batomys_granti	Muridae
crateromys_heaneyi	Muridae
batomys_salomonseni	Muridae
carpomys_phaeurus	Muridae
phloeomys_cumingi	Muridae
cremnomys_cutchicus	Muridae
gerbillus_hoogstrali	Muridae
gerbillus_hesperinus	Muridae
gerbillus_latastei	Muridae
gerbillus_occiduus	Muridae
gerbillus_tarabuli	Muridae
gerbillus_perpallidus	Muridae
gerbillus_floweri	Muridae
gerbillus_pyramidum	Muridae
gerbillus_andersoni	Muridae
gerbillus_nigeriae	Muridae
gerbillus_gerbillus	Muridae
gerbillus_cheesmani	Muridae
gerbillus_nancillus	Muridae
dipodillus_simoni	Muridae
dipodillus_dasyurus	Muridae
dipodillus_campestris	Muridae
dipodillus_rupicola	Muridae
gerbillus_nanus	Muridae
gerbillus_amoenus	Muridae
gerbillus_henleyi	Muridae
gerbillus_poecilops	Muridae
sekeetamys_calurus	Muridae
meriones_crassus	Muridae
meriones_rex	Muridae
meriones_tristrami	Muridae
meriones_libycus_erythrourus	Muridae
meriones_shawi	Muridae
meriones_penicilliger	Muridae
meriones_unguiculatus	Muridae
meriones_meridianus	Muridae
meriones_chengi	Muridae
psammomys_obesus	Muridae
psammomys_vexillaris	Muridae
brachiones_przewalskii	Muridae
rhombomys_opimus	Muridae
meriones_tamariscinus	Muridae
taterillus_pygargus	Muridae
taterillus_arenarius	Muridae
taterillus_gracilis	Muridae
gerbilliscus_kempi	Muridae
gerbilliscus_guineae	Muridae
gerbilliscus_gambianus	Muridae
gerbilliscus_afra	Muridae
gerbilliscus_brantsii	Muridae
gerbilliscus_leucogaster	Muridae
gerbillurus_vallinus	Muridae
gerbillurus_setzeri	Muridae
gerbillurus_paeba	Muridae
gerbillurus_tytonis	Muridae
gerbilliscus_robustus	Muridae
gerbilliscus_vicinus	Muridae
gerbilliscus_phillipsi	Muridae
gerbilliscus_nigricaudus	Muridae
tatera_indica	Muridae
desmodillus_auricularis	Muridae
pachyuromys_duprasi	Muridae
desmodilliscus_braueri	Muridae
lophiomys_imhausi	Muridae
mystromys_albicaudatus	Nesomyidae
petromyscus	Nesomyidae
phyllotis_xanthopygus_vaccarum	Cricetidae
phyllotis_limatus	Cricetidae
phyllotis_bonariensis	Cricetidae
phyllotis_magister	Cricetidae
phyllotis_darwini	Cricetidae
phyllotis_amicus	Cricetidae
phyllotis_andium	Cricetidae
phyllotis_gerbillus	Cricetidae
phyllotis_osilae	Cricetidae
phyllotis_alisosiensis	Cricetidae
auliscomys_boliviensis	Cricetidae
auliscomys_pictus	Cricetidae
auliscomys_sublimis	Cricetidae
galenomys_garleppi	Cricetidae
auliscomys_micropus	Cricetidae
tapecomys_wolffsohni	Cricetidae
tapecomys_primus	Cricetidae
salinomys_delicatus	Cricetidae
andalgalomys_pearsoni_dorbignyi	Cricetidae
andalgalomys_roigi	Cricetidae
eligmodontia_moreni	Cricetidae
eligmodontia_puerulus	Cricetidae
eligmodontia_hirtipes	Cricetidae
eligmodontia_morgani	Cricetidae
eligmodontia_typus	Cricetidae
eligmodontia_bolsonensis	Cricetidae
graomys_centralis	Cricetidae
graomys_griseoflavus	Cricetidae
graomys_chacoensis	Cricetidae
graomys_domorum	Cricetidae
calomys_venustus	Cricetidae
calomys_fecundus	Cricetidae
calomys_tocantinsi	Cricetidae
calomys_callosus	Cricetidae
calomys_aff_expulsus	Cricetidae
calomys_expulsus	Cricetidae
calomys_laucha	Cricetidae
calomys_tener	Cricetidae
calomys_hummelincki	Cricetidae
calomys_lepidus	Cricetidae
calomys_musculinus	Cricetidae
calomys_sorellus	Cricetidae
delomys_collinus	Cricetidae
delomys_sublineatus	Cricetidae
delomys_dorsalis	Cricetidae
abrothrix_olivaceus_brachiotis	Cricetidae
abrothrix_markhami	Cricetidae
abrothrix_hershkovitzi	Cricetidae
abrothrix_andinus	Cricetidae
abrothrix_lanosus	Cricetidae
abrothrix_jelskii	Cricetidae
abrothrix_illuteus	Cricetidae
abrothrix_longipilis_moerens	Cricetidae
chelemys_macronyx	Cricetidae
chelemys_megalonyx	Cricetidae
pearsonomys_annectens	Cricetidae
geoxus_valdivianus	Cricetidae
notiomys_edwardsii	Cricetidae
juliomys_pictipes	Cricetidae
wiedomys_cerradensis	Cricetidae
wiedomys_pyrrhorhinos	Cricetidae
phaenomys_ferrugineus	Cricetidae
andinomys_edax	Cricetidae
punomys_kofordi	Cricetidae
neomicroxus_latebricola	Cricetidae
neotomys_ebriosus	Cricetidae
euneomys_chinchilloides	Cricetidae
irenomys_tarsalis	Cricetidae
chinchillula_sahamae	Cricetidae
akodon_cursor	Cricetidae
akodon_aff_cursor	Cricetidae
akodon_montensis	Cricetidae
akodon_paranaensis	Cricetidae
akodon_mystax	Cricetidae
akodon_reigi	Cricetidae
akodon_polopi	Cricetidae
akodon_azarae	Cricetidae
akodon_fumeus	Cricetidae
akodon_kofordi	Cricetidae
akodon_juninensis	Cricetidae
akodon_lindberghi	Cricetidae
akodon_philipmyersi	Cricetidae
akodon_molinae	Cricetidae
akodon_dolores	Cricetidae
akodon_dayi	Cricetidae
akodon_lutescens	Cricetidae
akodon_subfuscus	Cricetidae
akodon_caenosus	Cricetidae
akodon_spegazzinii	Cricetidae
akodon_boliviensis	Cricetidae
akodon_viridescens	Cricetidae
akodon_sylvanus	Cricetidae
akodon_iniscatus_nucus	Cricetidae
akodon_toba	Cricetidae
akodon_tartareus	Cricetidae
abrothrix_xanthorhinus	Cricetidae
akodon_aerosus	Cricetidae
akodon_baliolus	Cricetidae
akodon_affinis	Cricetidae
akodon_albiventer	Cricetidae
akodon_mollis	Cricetidae
akodon_torques	Cricetidae
akodon_orophilus	Cricetidae
akodon_budini	Cricetidae
akodon_siberiae	Cricetidae
akodon_simulator	Cricetidae
akodon_glaucinus	Cricetidae
akodon_varius	Cricetidae
akodon_mimus	Cricetidae
deltamys_kempi	Cricetidae
akodon_serrensis	Cricetidae
thaptomys_nigrita	Cricetidae
thalpomys_cerradensis	Cricetidae
thalpomys_lasiotis	Cricetidae
necromys_temchuki	Cricetidae
necromys_lasiurus	Cricetidae
necromys_lactens	Cricetidae
necromys_urichi	Cricetidae
necromys_amoenus	Cricetidae
oxymycterus_quaestor	Cricetidae
oxymycterus_judex	Cricetidae
oxymycterus_rufus	Cricetidae
oxymycterus_paramensis	Cricetidae
oxymycterus_hiska	Cricetidae
oxymycterus_nasutus	Cricetidae
oxymycterus_dasytrichus	Cricetidae
oxymycterus_delator	Cricetidae
oxymycterus_amazonicus	Cricetidae
juscelinomys_huanchacae	Cricetidae
brucepattersonius	Cricetidae
brucepattersonius_iheringi	Cricetidae
blarinomys_breviceps	Cricetidae
lenoxus_apicalis	Cricetidae
scapteromys_tumidus	Cricetidae
scapteromys_aquaticus	Cricetidae
kunsia_tomentosus	Cricetidae
bibimys	Cricetidae
thomasomys_australis	Cricetidae
thomasomys_daphne	Cricetidae
thomasomys_erro	Cricetidae
thomasomys_fumeus	Cricetidae
thomasomys_vulcani	Cricetidae
thomasomys_cinnameus	Cricetidae
thomasomys_paramorum	Cricetidae
thomasomys_caudivarius	Cricetidae
thomasomys_ucucha	Cricetidae
thomasomys_silvestris	Cricetidae
thomasomys_andersoni	Cricetidae
thomasomys_oreas	Cricetidae
thomasomys_gracilis	Cricetidae
thomasomys_princeps	Cricetidae
thomasomys_ischyurus	Cricetidae
thomasomys_taczanowskii	Cricetidae
thomasomys_baeops	Cricetidae
thomasomys_notatus	Cricetidae
thomasomys_aureus	Cricetidae
chilomys_instans	Cricetidae
rhipidomys_nitela	Cricetidae
rhipidomys_macconnelli	Cricetidae
rhipidomys_wetzeli	Cricetidae
rhipidomys_mastacalis	Cricetidae
rhagomys	Cricetidae
aepeomys_lugens	Cricetidae
abrawayaomys_ruschii	Cricetidae
reithrodon_auritus	Cricetidae
melanomys_idoneus	Cricetidae
melanomys_columbianus	Cricetidae
melanomys_caliginosus	Cricetidae
sigmodontomys_alfari	Cricetidae
melanomys_chrysomelas	Cricetidae
tanyuromys_aphrastus	Cricetidae
nesoryzomys_narboroughi	Cricetidae
nesoryzomys_swarthi	Cricetidae
nesoryzomys_fernandinae	Cricetidae
aegialomys_galapagoensis	Cricetidae
aegialomys_xanthaeolus	Cricetidae
oryzomys_palustris_planirostris	Cricetidae
oryzomys_texensis	Cricetidae
oryzomys_couesi	Cricetidae
oryzomys_mexicanus	Cricetidae
nectomys_apicalis	Cricetidae
nectomys_squamipes	Cricetidae
amphinectomys_savamis	Cricetidae
holochilus_sciureus	Cricetidae
holochilus_chacarius	Cricetidae
holochilus_brasiliensis	Cricetidae
pseudoryzomys_simplex	Cricetidae
cerradomys_subflavus	Cricetidae
cerradomys_scotti	Cricetidae
sooretamys_angouya	Cricetidae
lundomys_molitor	Cricetidae
drymoreomys_albimaculatus	Cricetidae
eremoryzomys_polius	Cricetidae
oligoryzomys_stramineus	Cricetidae
oligoryzomys_nigripes	Cricetidae
oligoryzomys_flavescens	Cricetidae
oligoryzomys_destructor	Cricetidae
oligoryzomys_eliurus	Cricetidae
oligoryzomys_chacoensis	Cricetidae
oligoryzomys_longicaudatus	Cricetidae
oligoryzomys_magellanicus	Cricetidae
oligoryzomys_fornesi	Cricetidae
oligoryzomys_andinus	Cricetidae
oligoryzomys_rupestris	Cricetidae
oligoryzomys_utiaritensis	Cricetidae
oligoryzomys_fulvescens	Cricetidae
oligoryzomys_moojeni	Cricetidae
oligoryzomys_vegetus	Cricetidae
oligoryzomys_microtis	Cricetidae
neacomys_musseri	Cricetidae
neacomys_guianae	Cricetidae
neacomys_dubosti	Cricetidae
neacomys_spinosus	Cricetidae
neacomys_paracou	Cricetidae
neacomys_minutus	Cricetidae
microryzomys_minutus	Cricetidae
oreoryzomys_balneator	Cricetidae
oecomys_mamorae	Cricetidae
oecomys_trinitatis	Cricetidae
oecomys_concolor	Cricetidae
oecomys_superans	Cricetidae
oecomys_bicolor	Cricetidae
oecomys_roberti	Cricetidae
oecomys_rutilus	Cricetidae
oecomys_auyantepui	Cricetidae
oecomys_catherinae	Cricetidae
euryoryzomys_lamia	Cricetidae
euryoryzomys_nitidus	Cricetidae
euryoryzomys_russatus	Cricetidae
euryoryzomys_macconnelli	Cricetidae
transandinomys_bolivaris	Cricetidae
transandinomys_talamancae	Cricetidae
hylaeamys_megacephalus	Cricetidae
hylaeamys_perenensis	Cricetidae
hylaeamys_acritus	Cricetidae
hylaeamys_laticeps	Cricetidae
hylaeamys_yunganus	Cricetidae
nephelomys_levipes	Cricetidae
nephelomys_keaysi	Cricetidae
nephelomys_albigularis	Cricetidae
handleyomys_rostratus	Cricetidae
handleyomys_melanotis	Cricetidae
handleyomys_alfaroi	Cricetidae
handleyomys_saturatior	Cricetidae
handleyomys_chapmani	Cricetidae
handleyomys_guerrerensis	Cricetidae
zygodontomys_cherriei	Cricetidae
zygodontomys_microtinus	Cricetidae
zygodontomys_brevicauda	Cricetidae
scolomys_juruaense	Cricetidae
scolomys_ucayalensis	Cricetidae
sigmodon_hispidus_texianus	Cricetidae
sigmodon_arizonae_major	Cricetidae
sigmodon_mascotensis	Cricetidae
sigmodon_hirsutus	Cricetidae
sigmodon_alleni	Cricetidae
sigmodon_toltecus	Cricetidae
sigmodon_ochrognathus	Cricetidae
sigmodon_fulviventer	Cricetidae
sigmodon_leucotis	Cricetidae
sigmodon_peruanus	Cricetidae
sigmodon_alstoni	Cricetidae
neusticomys_monticolus	Cricetidae
rheomys_raptor	Cricetidae
nannospalax_leucodon_hungaricus	Spalacidae
nannospalax_nehringi	Spalacidae
nannospalax_ehrenbergi	Spalacidae
nannospalax_judaei	Spalacidae
nannospalax_carmeli	Spalacidae
nannospalax_golani	Spalacidae
nannospalax_galili	Spalacidae
nannospalax_ceyhanus	Spalacidae
spalax_arenarius	Spalacidae
spalax_zemni	Spalacidae
spalax_microphthalmus	Spalacidae
spalax_graecus_mezosegiensis	Spalacidae
eospalax_cansus	Spalacidae
eospalax_baileyi	Spalacidae
eospalax_smithii	Spalacidae
eospalax_fontanierii	Spalacidae
eospalax_rothschildi	Spalacidae
eospalax_rufescens	Spalacidae
myospalax_aspalax	Spalacidae
myospalax_psilurus	Spalacidae
rhizomys_sinensis	Spalacidae
rhizomys_pruinosus	Spalacidae
cannomys_badius	Spalacidae
tachyoryctes_splendens	Spalacidae
typhlomys_cinereus	Platacanthomyidae
typhlomys_chapensis	Platacanthomyidae
zapus_princeps_curtatus	Dipodidae
zapus_trinotatus_eureka	Dipodidae
zapus_hudsonius	Dipodidae
napaeozapus_insignis	Dipodidae
eozapus_setchuanus	Dipodidae
allactaga_bullata	Dipodidae
allactaga_sibirica	Dipodidae
allactaga_balikunica	Dipodidae
allactodipus_bobrinskii	Dipodidae
allactaga_major	Dipodidae
pygeretmus_pumilio	Dipodidae
allactaga_euphratica	Dipodidae
allactaga_williamsi	Dipodidae
allactaga_hotsoni	Dipodidae
allactaga_firouzi	Dipodidae
allactaga_toussi	Dipodidae
allactaga_elater	Dipodidae
euchoreutes_naso	Dipodidae
jaculus_jaculus	Dipodidae
jaculus_deserti	Dipodidae
jaculus_blanfordi	Dipodidae
jaculus_orientalis	Dipodidae
eremodipus_lichtensteini	Dipodidae
stylodipus_sungorus	Dipodidae
stylodipus_telum	Dipodidae
stylodipus_andrewsi	Dipodidae
dipus_sagitta	Dipodidae
paradipus_ctenodactylus	Dipodidae
cardiocranius_paradoxus	Dipodidae
salpingotus_kozlovi	Dipodidae
sicista_severtzovi_cimlanica	Dipodidae
sicista_subtilis_subtilis	Dipodidae
sicista_strandi	Dipodidae
sicista_betulina	Dipodidae
sicista_napaea	Dipodidae
sicista_caucasica	Dipodidae
sicista_kluchorica	Dipodidae
sicista_kazbegica	Dipodidae
sicista_concolor	Dipodidae
sicista_tianshanica	Sminthidae
cratogeomys_zinseri	Geomyidae
cratogeomys_fumosus_angustirostris	Geomyidae
cratogeomys_neglectus	Geomyidae
cratogeomys_gymnurus	Geomyidae
cratogeomys_tylorhinus	Geomyidae
cratogeomys_planiceps	Geomyidae
cratogeomys_perotensis	Geomyidae
cratogeomys_merriami	Geomyidae
cratogeomys_fulvescens	Geomyidae
cratogeomys_goldmani_rubellus	Geomyidae
cratogeomys_castanops	Geomyidae
pappogeomys_bulleri	Geomyidae
orthogeomys_matagalpae	Geomyidae
orthogeomys_cherriei	Geomyidae
orthogeomys_heterodus	Geomyidae
orthogeomys_underwoodi	Geomyidae
orthogeomys_thaeleri	Geomyidae
orthogeomys_dariensis	Geomyidae
orthogeomys_cavator	Geomyidae
orthogeomys_lanius	Geomyidae
orthogeomys_hispidus	Geomyidae
orthogeomys_grandis	Geomyidae
geomys_bursarius_industrius	Geomyidae
geomys_jugossicularis_halli	Geomyidae
geomys_lutescens	Geomyidae
geomys_texensis	Geomyidae
geomys_knoxjonesi	Geomyidae
geomys_arenarius	Geomyidae
geomys_personatus_davisi	Geomyidae
geomys_tropicalis	Geomyidae
geomys_streckeri	Geomyidae
geomys_attwateri	Geomyidae
geomys_breviceps_sagittalis	Geomyidae
geomys_pinetis_mobilensis	Geomyidae
zygogeomys_trichopus	Geomyidae
thomomys_bottae_anitae	Geomyidae
thomomys_townsendii	Geomyidae
thomomys_sheldoni	Geomyidae
thomomys_umbrinus	Geomyidae
thomomys_atrovarius	Geomyidae
thomomys_bulbivorus	Geomyidae
thomomys_monticola	Geomyidae
thomomys_mazama	Geomyidae
thomomys_talpoides	Geomyidae
chaetodipus_penicillatus	Heteromyidae
chaetodipus_eremicus	Heteromyidae
chaetodipus_pernix	Heteromyidae
chaetodipus_intermedius	Heteromyidae
chaetodipus_goldmani	Heteromyidae
chaetodipus_artus	Heteromyidae
chaetodipus_nelsoni	Heteromyidae
chaetodipus_arenarius	Heteromyidae
chaetodipus_dalquesti	Heteromyidae
chaetodipus_siccus	Heteromyidae
chaetodipus_fallax	Heteromyidae
chaetodipus_californicus	Heteromyidae
chaetodipus_spinatus	Heteromyidae
chaetodipus_baileyi	Heteromyidae
chaetodipus_rudinoris	Heteromyidae
chaetodipus_hispidus	Heteromyidae
chaetodipus_formosus	Heteromyidae
perognathus_longimembris	Heteromyidae
perognathus_inornatus	Heteromyidae
perognathus_amplus	Heteromyidae
perognathus_merriami	Heteromyidae
perognathus_flavus	Heteromyidae
perognathus_apache	Heteromyidae
perognathus_fasciatus	Heteromyidae
perognathus_flavescens	Heteromyidae
perognathus_mollipilosus	Heteromyidae
perognathus_alticolus	Heteromyidae
perognathus_parvus	Heteromyidae
heteromys_desmarestianus	Heteromyidae
heteromys_goldmani	Heteromyidae
heteromys_oresterus	Heteromyidae
heteromys_nubicolens	Heteromyidae
heteromys_gaumeri	Heteromyidae
heteromys_anomalus	Heteromyidae
heteromys_australis	Heteromyidae
heteromys_nelsoni	Heteromyidae
liomys_irroratus	Heteromyidae
liomys_pictus	Heteromyidae
liomys_spectabilis	Heteromyidae
liomys_adspersus	Heteromyidae
liomys_salvini	Heteromyidae
dipodomys_merriami_brunensis	Heteromyidae
dipodomys_insularis	Heteromyidae
dipodomys_nitratoides	Heteromyidae
dipodomys_phillipsii	Heteromyidae
dipodomys_elator	Heteromyidae
dipodomys_compactus	Heteromyidae
dipodomys_panamintinus	Heteromyidae
dipodomys_heermanni	Heteromyidae
dipodomys_stephensi	Heteromyidae
dipodomys_ingens	Heteromyidae
dipodomys_microps	Heteromyidae
dipodomys_gravipes	Heteromyidae
dipodomys_agilis	Heteromyidae
dipodomys_simulans	Heteromyidae
dipodomys_venustus	Heteromyidae
dipodomys_elephantinus	Heteromyidae
dipodomys_californicus	Heteromyidae
dipodomys_spectabilis	Heteromyidae
dipodomys_nelsoni	Heteromyidae
dipodomys_deserti	Heteromyidae
dipodomys_ordii	Heteromyidae
microdipodops_megacephalus	Heteromyidae
microdipodops_pallidus	Heteromyidae
castor_fiber_birulai	Castoridae
castor_canadensis	Castoridae
idiurus_macrotis	Anomaluridae
anomalurus	Anomaluridae
pedetes_capensis	Pedetidae
cercopithecus_mitis	Cercopithecidae
cercopithecus_nictitans_nictitans	Cercopithecidae
cercopithecus_ascanius_whitesidei	Cercopithecidae
cercopithecus_cephus_cephodes	Cercopithecidae
cercopithecus_erythrotis_camerunensis	Cercopithecidae
cercopithecus_petaurista_buettikoferi	Cercopithecidae
cercopithecus_erythrogaster_pococki	Cercopithecidae
cercopithecus_preussi_preussi	Cercopithecidae
cercopithecus_lhoesti	Cercopithecidae
erythrocebus_patas	Cercopithecidae
cercopithecus_wolfi_elegans	Cercopithecidae
cercopithecus_denti	Cercopithecidae
cercopithecus_pogonias_schwarzianus	Cercopithecidae
cercopithecus_mona	Cercopithecidae
cercopithecus_campbelli	Cercopithecidae
cercopithecus_neglectus	Cercopithecidae
cercopithecus_diana	Cercopithecidae
cercopithecus_roloway	Cercopithecidae
chlorocebus_djamdjamensis	Cercopithecidae
chlorocebus_aethiops	Cercopithecidae
chlorocebus_tantalus	Cercopithecidae
chlorocebus_pygerythrus	Cercopithecidae
chlorocebus_cynosuros	Cercopithecidae
cercopithecus_dryas	Cercopithecidae
chlorocebus_sabaeus	Cercopithecidae
cercopithecus_solatus	Cercopithecidae
cercopithecus_hamlyni	Cercopithecidae
miopithecus_talapoin	Cercopithecidae
miopithecus_ogouensis	Cercopithecidae
allenopithecus_nigroviridis	Cercopithecidae
macaca_nigra	Cercopithecidae
macaca_mulatta_lasiotus	Cercopithecidae
macaca_cyclopis	Cercopithecidae
macaca_fuscata	Cercopithecidae
macaca_arctoides	Cercopithecidae
macaca_fascicularis	Cercopithecidae
macaca_thibetana	Cercopithecidae
macaca_assamensis	Cercopithecidae
macaca_sinica	Cercopithecidae
macaca_radiata	Cercopithecidae
macaca_nemestrina	Cercopithecidae
macaca_nigrescens	Cercopithecidae
macaca_maura	Cercopithecidae
macaca_hecki	Cercopithecidae
macaca_brunnescens	Cercopithecidae
macaca_ochreata	Cercopithecidae
macaca_tonkeana	Cercopithecidae
macaca_silenus	Cercopithecidae
macaca_leonina	Cercopithecidae
macaca_siberu	Cercopithecidae
macaca_pagensis	Cercopithecidae
macaca_sylvanus	Cercopithecidae
rungwecebus_kipunji	Cercopithecidae
papio_ursinus	Cercopithecidae
papio_kindae	Cercopithecidae
papio_papio	Cercopithecidae
papio_cynocephalus_ibeanus	Cercopithecidae
papio_hamadryas	Cercopithecidae
papio_anubis	Cercopithecidae
lophocebus_aterrimus	Cercopithecidae
theropithecus_gelada	Cercopithecidae
cercocebus_agilis	Cercopithecidae
cercocebus_chrysogaster	Cercopithecidae
cercocebus_galeritus	Cercopithecidae
mandrillus_leucophaeus	Cercopithecidae
mandrillus_sphinx	Cercopithecidae
cercocebus_atys_lunulatus	Cercopithecidae
cercocebus_torquatus	Cercopithecidae
trachypithecus_phayrei	Cercopithecidae
trachypithecus_germaini	Cercopithecidae
trachypithecus_cristatus	Cercopithecidae
trachypithecus_obscurus	Cercopithecidae
trachypithecus_delacouri	Cercopithecidae
trachypithecus_poliocephalus	Cercopithecidae
trachypithecus_hatinhensis	Cercopithecidae
trachypithecus_francoisi	Cercopithecidae
trachypithecus_shortridgei	Cercopithecidae
trachypithecus_pileatus	Cercopithecidae
presbytis_comata_comata	Cercopithecidae
presbytis_melalophos_mitrata	Cercopithecidae
presbytis_rubicunda_rubicunda	Cercopithecidae
presbytis_potenziani_potenziani	Cercopithecidae
presbytis_chrysomelas	Cercopithecidae
presbytis_frontata	Cercopithecidae
presbytis_hosei_hosei	Cercopithecidae
presbytis_thomasi	Cercopithecidae
rhinopithecus_bieti_1_rl_2012	Cercopithecidae
rhinopithecus_strykeri	Cercopithecidae
rhinopithecus_roxellana	Cercopithecidae
rhinopithecus_brelichi	Cercopithecidae
rhinopithecus_avunculus	Cercopithecidae
nasalis_larvatus	Cercopithecidae
simias_concolor	Cercopithecidae
pygathrix_cinerea	Cercopithecidae
pygathrix_nemaeus	Cercopithecidae
pygathrix_nigripes	Cercopithecidae
trachypithecus_johnii	Cercopithecidae
semnopithecus_entellus	Cercopithecidae
trachypithecus_vetulus	Cercopithecidae
trachypithecus_geei	Cercopithecidae
trachypithecus_auratus	Cercopithecidae
piliocolobus_kirkii	Cercopithecidae
piliocolobus_gordonorum	Cercopithecidae
piliocolobus_rufomitratus	Cercopithecidae
piliocolobus_tephrosceles	Cercopithecidae
piliocolobus_foai	Cercopithecidae
piliocolobus_tholloni	Cercopithecidae
piliocolobus_pennantii	Cercopithecidae
piliocolobus_preussi	Cercopithecidae
piliocolobus_badius	Cercopithecidae
procolobus_verus	Cercopithecidae
colobus_guereza_kikuyuensis	Cercopithecidae
colobus_polykomos	Cercopithecidae
colobus_vellerosus	Cercopithecidae
colobus_angolensis	Cercopithecidae
colobus_satanas_satanas	Cercopithecidae
hylobates_agilis_unko	Hylobatidae
hylobates_alibarbis	Hylobatidae
hylobates_klossii	Hylobatidae
hylobates_moloch	Hylobatidae
hylobates_muelleri	Hylobatidae
hylobates_lar_entelloides	Hylobatidae
hylobates_pileatus	Hylobatidae
hoolock_leuconedys	Hylobatidae
hoolock_hoolock	Hylobatidae
symphalangus_syndactylus	Hylobatidae
nomascus_concolor_jingdongensis	Hylobatidae
nomascus_siki	Hylobatidae
nomascus_leucogenys	Hylobatidae
nomascus_gabriellae	Hylobatidae
nomascus_nasutus	Hylobatidae
nomascus_hainanus	Hylobatidae
nomascus_annamensis	Hylobatidae
pan_troglodytes_ellioti	Hominidae
pan_paniscus	Hominidae
homo_sapiens	Hominidae
gorilla_beringei_graueri	Hominidae
gorilla_gorilla	Hominidae
pongo_pygmaeus	Hominidae
pongo_abelii	Hominidae
saguinus_melanoleucus	Cebidae
saguinus_fuscicollis_weddelli	Cebidae
saguinus_cruzlimai	Cebidae
saguinus_tripartitus	Cebidae
saguinus_graellsi	Cebidae
saguinus_nigricollis_nigricollis	Cebidae
saguinus_bicolor	Cebidae
saguinus_martinsi	Cebidae
saguinus_niger	Cebidae
saguinus_midas	Cebidae
saguinus_geoffroyi	Cebidae
saguinus_oedipus	Cebidae
saguinus_leucopus	Cebidae
saguinus_mystax	Cebidae
saguinus_labiatus	Cebidae
saguinus_imperator	Cebidae
leontopithecus_chrysomelas	Cebidae
leontopithecus_rosalia	Cebidae
callithrix_mauesi	Cebidae
callithrix_saterei	Cebidae
callithrix_humeralifera	Cebidae
callithrix_emiliae	Cebidae
callithrix_argentata	Cebidae
callithrix_pygmaea	Cebidae
callithrix_penicillata	Cebidae
callithrix_jacchus	Cebidae
callithrix_kuhlii	Cebidae
callithrix_geoffroyi	Cebidae
callithrix_aurita	Cebidae
callimico_goeldii	Cebidae
sapajus_cay	Cebidae
sapajus_flavius	Cebidae
sapajus_macrocephalus	Cebidae
sapajus_libidinosus	Cebidae
sapajus_robustus	Cebidae
sapajus_nigritus	Cebidae
sapajus_xanthosternos	Cebidae
sapajus_apella	Cebidae
cebus_kaapori	Cebidae
cebus_olivaceus	Cebidae
cebus_albifrons	Cebidae
cebus_capucinus	Cebidae
saimiri_sciureus_collinsi	Cebidae
saimiri_vanzolinii	Cebidae
saimiri_ustus	Cebidae
saimiri_oerstedii_citrinellus	Cebidae
saimiri_boliviensis_peruviensis	Cebidae
aotus_griseimembra	Aotidae
aotus_lemurinus	Aotidae
aotus_trivirgatus	Aotidae
aotus_vociferans	Aotidae
aotus_brumbacki	Aotidae
aotus_azarai_boliviensis	Aotidae
aotus_nigriceps	Aotidae
aotus_nancymaae	Aotidae
ateles_geoffroyi_panamensis	Atelidae
ateles_fusciceps_robustus	Atelidae
ateles_belzebuth_marginatus	Atelidae
ateles_hybridus	Atelidae
ateles_paniscus	Atelidae
lagothrix_cana	Atelidae
lagothrix_lagotricha	Atelidae
lagothrix_poeppigii	Atelidae
lagothrix_lugens	Atelidae
brachyteles_hypoxanthus	Atelidae
brachyteles_arachnoides	Atelidae
alouatta_palliata_mexicana	Atelidae
alouatta_pigra	Atelidae
alouatta_sara	Atelidae
alouatta_seniculus	Atelidae
alouatta_stramineus	Atelidae
alouatta_macconnelli	Atelidae
alouatta_caraya	Atelidae
alouatta_belzebul	Atelidae
alouatta_guariba	Atelidae
cacajao_calvus_novaesi	Pitheciidae
cacajao_rubicundus	Pitheciidae
cacajao_melanocephalus	Pitheciidae
cacajao_hosomi	Pitheciidae
cacajao_ayresi	Pitheciidae
chiropotes_satanas	Pitheciidae
chiropotes_israelita	Pitheciidae
chiropotes_chiropotes_sagulata	Pitheciidae
chiropotes_utahickae	Pitheciidae
chiropotes_albinasus	Pitheciidae
pithecia_irrorata	Pitheciidae
pithecia_monachus	Pitheciidae
pithecia_pithecia	Pitheciidae
plecturocebus_donacophilus	Pitheciidae
plecturocebus_cupreus	Pitheciidae
plecturocebus_hoffmannsi	Pitheciidae
plecturocebus_brunneus	Pitheciidae
plecturocebus_moloch	Pitheciidae
callicebus_personatus	Pitheciidae
cheracebus_purinus	Pitheciidae
cheracebus_torquatus	Pitheciidae
cheracebus_lugens	Pitheciidae
tarsius_sangirensis	Tarsiidae
tarsius_lariang	Tarsiidae
tarsius_wallacei	Tarsiidae
tarsius_tarsier	Tarsiidae
tarsius_dentatus	Tarsiidae
tarsius_bancanus	Tarsiidae
tarsius_syrichta	Tarsiidae
microcebus_myoxinus	Cheirogaleidae
microcebus_rufus	Cheirogaleidae
microcebus_berthae	Cheirogaleidae
microcebus_lehilahytsara	Cheirogaleidae
microcebus_margotmarshae	Cheirogaleidae
microcebus_arnholdi	Cheirogaleidae
microcebus_simmonsi	Cheirogaleidae
microcebus_lokobensis	Cheirogaleidae
microcebus_sambiranensis	Cheirogaleidae
microcebus_mamiratra	Cheirogaleidae
microcebus_mittermeieri	Cheirogaleidae
microcebus_tavaratra	Cheirogaleidae
microcebus_tanosi	Cheirogaleidae
microcebus_marohita	Cheirogaleidae
microcebus_gerpi	Cheirogaleidae
microcebus_jollyae	Cheirogaleidae
microcebus_bongolavensis	Cheirogaleidae
microcebus_ravelobensis	Cheirogaleidae
microcebus_danfossi	Cheirogaleidae
microcebus_macarthurii	Cheirogaleidae
microcebus_griseorufus	Cheirogaleidae
microcebus_murinus	Cheirogaleidae
mirza_zaza	Cheirogaleidae
mirza_coquereli	Cheirogaleidae
allocebus_trichotis	Cheirogaleidae
cheirogaleus_lavasoensis	Cheirogaleidae
cheirogaleus_crossleyi	Cheirogaleidae
cheirogaleus_major	Cheirogaleidae
cheirogaleus_sibreei	Cheirogaleidae
cheirogaleus_medius	Cheirogaleidae
lepilemur_mittermeieri	Lepilemuridae
lepilemur_sahamalazensis	Lepilemuridae
lepilemur_dorsalis	Lepilemuridae
lepilemur_ankaranensis	Lepilemuridae
lepilemur_septentrionalis	Lepilemuridae
lepilemur_microdon	Lepilemuridae
lepilemur_seali	Lepilemuridae
lepilemur_otto	Lepilemuridae
lepilemur_edwardsi	Lepilemuridae
lepilemur_aeeclis	Lepilemuridae
lepilemur_mitsinjoensis	Lepilemuridae
lepilemur_randrianasoloi	Lepilemuridae
lepilemur_hubbardorum	Lepilemuridae
lepilemur_ruficaudatus	Lepilemuridae
lepilemur_leucopus	Lepilemuridae
lepilemur_petteri	Lepilemuridae
lepilemur_mustelinus	Lepilemuridae
lepilemur_jamesi	Lepilemuridae
phaner	Cheirogaleidae
eulemur_fulvus_mayottensis	Lemuridae
eulemur_albifrons	Lemuridae
eulemur_sanfordi	Lemuridae
eulemur_rufifrons	Lemuridae
eulemur_rufus	Lemuridae
eulemur_cinereiceps	Lemuridae
eulemur_collaris	Lemuridae
eulemur_mongoz	Lemuridae
eulemur_rubriventer	Lemuridae
eulemur_macaco_macaco	Lemuridae
eulemur_flavifrons	Lemuridae
eulemur_coronatus	Lemuridae
hapalemur_griseus_alaotrensis	Lemuridae
hapalemur_aureus	Lemuridae
prolemur_simus	Lemuridae
lemur_catta	Lemuridae
varecia_variegata_variegata	Lemuridae
varecia_rubra	Lemuridae
pachylemur_jullyi	Lemuridae
megaladapis_edwardsi	Lepilemuridae
propithecus_deckenii	Indriidae
propithecus_verreauxi	Indriidae
propithecus_coronatus	Indriidae
propithecus_tattersalli	Indriidae
propithecus_coquereli	Indriidae
propithecus_edwardsi	Indriidae
propithecus_diadema	Indriidae
propithecus_perrieri	Indriidae
avahi_unicolor	Indriidae
avahi_cleesei	Indriidae
avahi_occidentalis	Indriidae
avahi_peyrierasi	Indriidae
avahi_laniger	Indriidae
indri_indri	Indriidae
palaeopropithecus_ingens	Palaeopropithecidae
daubentonia_madagascariensis	Daubentoniidae
galago_senegalensis	Galagidae
galago_moholi	Galagidae
galago_matschiei	Galagidae
euoticus_elegantulus	Galagidae
galagoides_zanzibaricus_udzungwensis	Galagidae
galagoides_cocos	Galagidae
galagoides_granti	Galagidae
galagoides_rondoensis	Galagidae
galagoides_orinus	Galagidae
otolemur_monteiri_argentatus	Galagidae
otolemur_crassicaudatus	Galagidae
otolemur_garnettii	Galagidae
galago_gabonensis	Galagidae
galago_alleni	Galagidae
galagoides_demidoff	Galagidae
galagoides_thomasi	Galagidae
nycticebus_coucang	Lorisidae
nycticebus_bengalensis	Lorisidae
nycticebus_javanicus	Lorisidae
nycticebus_menagensis	Lorisidae
nycticebus_pygmaeus	Lorisidae
loris_lydekkerianus_nordicus	Lorisidae
loris_tardigradus	Lorisidae
perodicticus_potto	Lorisidae
arctocebus_calabarensis	Lorisidae
arctocebus_aureus	Lorisidae
galeopterus_variegatus_peninsulae	Cynocephalidae
cynocephalus_volans	Cynocephalidae